PRACTICE_CODE,TOTAL,16OV,17OV,18OV,30_74,50OV,0_64,65OV,65OV%
A81001,4111,3345,3307,3258,2228,1716,3161,950,0.231087327
A81002,19189,16000,15801,15602,11050,8595,14979,4210,0.219396529
A81004,11014,9050,8932,8808,6048,4151,8902,2112,0.191755947
A81005,8154,6844,6769,6694,4784,4050,5768,2386,0.29261712
A81006,14709,11883,11725,11581,8343,5746,12021,2688,0.182745258
A81007,9877,8033,7914,7802,5523,3966,7985,1892,0.191556141
A81009,8416,6842,6730,6629,4745,3288,6979,1437,0.170746198
A81011,11822,9767,9642,9532,6676,4935,9400,2422,0.204872272
A81012,5035,3948,3889,3831,2703,1711,4367,668,0.132671301
A81013,6833,5530,5462,5394,3928,2795,5459,1374,0.20108298
A81014,3885,3311,3282,3244,2224,1961,2821,1064,0.273873874
A81016,10504,8404,8306,8189,5441,3013,9119,1385,0.131854532
A81017,18874,14962,14689,14444,10753,6794,15891,2983,0.158048109
A81018,10153,8249,8140,8041,5745,4287,8000,2153,0.21205555
A81019,9199,7225,7092,6965,4957,3400,7708,1491,0.162082835
A81020,8128,6544,6473,6379,4509,3298,6368,1760,0.216535433
A81021,13521,10944,10791,10667,7537,5413,10874,2647,0.195769544
A81022,10017,8299,8176,8090,5877,4438,7781,2236,0.223220525
A81023,7863,6321,6233,6158,4123,2257,6940,923,0.117385222
A81025,4069,3332,3295,3247,2295,1676,3219,850,0.208896535
A81026,19668,15339,15145,14941,10614,6742,16582,3086,0.156904617
A81027,15360,12662,12505,12322,9151,6723,11879,3481,0.226627604
A81029,6606,5489,5432,5377,3417,1790,5826,780,0.118074478
A81030,14296,11412,11242,11090,7674,5469,11568,2728,0.190822608
A81031,12813,10436,10307,10158,7117,5023,10449,2364,0.184500117
A81032,11006,9296,9188,9074,6355,5171,8273,2733,0.248319099
A81034,22188,17330,17021,16764,12483,7492,19110,3078,0.138723634
A81035,10177,8167,8008,7892,5619,3524,8546,1631,0.160263339
A81036,17460,14113,13913,13740,9916,6967,13940,3520,0.201603666
A81037,6977,5690,5608,5533,3493,2148,6098,879,0.125985381
A81038,3711,2805,2750,2705,1935,1072,3245,466,0.125572622
A81039,10772,8656,8515,8398,6313,4215,8716,2056,0.190865206
A81040,8545,6943,6866,6785,5052,3507,6977,1568,0.183499122
A81041,9268,7709,7624,7532,5446,4079,7344,1924,0.207596029
A81042,14176,11295,11127,10951,7813,5363,11799,2377,0.167677765
A81043,8600,7056,6972,6875,4776,3663,6826,1774,0.20627907
A81044,18731,15527,15299,15098,10916,7747,15131,3600,0.192194757
A81045,6725,5594,5526,5462,3808,2942,5259,1466,0.217992565
A81046,12331,10088,9980,9874,7007,5165,9793,2538,0.205822723
A81048,7283,6216,6147,6080,4215,3786,5080,2203,0.30248524
A81049,6775,5230,5147,5072,3587,2276,5770,1005,0.148339483
A81051,6436,5242,5162,5089,3722,2599,5208,1228,0.19080174
A81052,9058,7447,7360,7275,5177,3910,7162,1896,0.20931773
A81053,6411,5237,5170,5117,3612,2768,4970,1441,0.224769927
A81054,8192,6792,6694,6595,4683,3405,6563,1629,0.198852539
A81056,2565,2152,2133,2114,1505,1215,2043,522,0.203508772
A81057,9093,7317,7217,7121,5111,3567,7517,1576,0.173320136
A81058,8893,6970,6830,6722,4844,3483,7123,1770,0.199032947
A81060,5802,4743,4670,4617,3318,2483,4592,1210,0.208548776
A81063,5549,4488,4426,4355,3187,2145,4507,1042,0.187781582
A81064,7241,5975,5920,5865,3618,1835,6437,804,0.111034388
A81065,3947,3064,3024,2990,2146,1338,3414,533,0.13503927
A81066,4738,3954,3894,3853,2890,2128,3774,964,0.203461376
A81067,12189,10010,9892,9692,5695,3297,10741,1448,0.118795635
A81070,7019,5347,5246,5168,3818,2171,6065,954,0.135916797
A81602,2410,2069,2046,2020,1421,1193,1779,631,0.261825726
A81608,5413,4025,3956,3898,2781,1443,4825,588,0.108627379
A81610,7819,6236,6156,6060,4367,2968,6508,1311,0.1676685
A81611,7776,6141,6048,5973,4379,2826,6421,1355,0.174254115
A81612,3466,2861,2827,2791,2089,1505,2728,738,0.212925563
A81618,9780,8356,8246,8153,5868,4869,7181,2599,0.265746421
A81621,2371,1641,1602,1573,1108,539,2190,181,0.076339097
A81622,5564,4421,4366,4305,2966,2053,4645,919,0.165168943
A81629,4755,3802,3751,3688,2731,1659,3964,791,0.166351209
A81630,795,761,760,758,718,100,791,4,0.005031447
A81631,6858,5525,5435,5342,3797,2701,5615,1243,0.181248177
A81633,1189,990,986,979,454,34,1183,6,0.005046257
A81634,2291,1868,1853,1839,1071,195,2229,62,0.027062418
A82003,11155,9496,9379,9264,6660,5315,8323,2832,0.253877185
A82004,2232,1952,1930,1915,1436,1212,1650,582,0.260752688
A82005,6276,5668,5624,5588,3767,2883,4783,1493,0.237890376
A82006,4989,4319,4257,4214,3007,2705,3488,1501,0.300861896
A82007,9729,7983,7884,7784,5500,3924,7806,1923,0.197656491
A82008,11135,9196,9095,9001,6365,4879,8588,2547,0.228738213
A82009,8947,7385,7279,7186,5060,3746,6991,1956,0.218620767
A82010,6578,5515,5432,5373,3840,2836,5279,1299,0.197476437
A82012,16147,13771,13607,13420,9891,8630,11591,4556,0.282157676
A82013,6606,5643,5571,5506,3934,3531,4680,1926,0.291553134
A82014,4268,3799,3746,3712,2623,2467,2968,1300,0.304592315
A82015,5415,4503,4458,4419,3206,2034,4448,967,0.178578024
A82016,36971,30300,29879,29480,20935,14858,29530,7441,0.201265857
A82018,12693,10441,10322,10216,7399,4991,10271,2422,0.190813834
A82019,8408,7008,6926,6844,4437,3166,6895,1513,0.179947669
A82020,15050,12192,12044,11891,8756,6026,12028,3022,0.200797342
A82021,17273,14682,14501,14325,10515,8570,12844,4429,0.256411741
A82022,5181,4377,4295,4204,2931,2484,3851,1330,0.256707199
A82023,5136,4308,4262,4212,3079,2397,3895,1241,0.241627726
A82024,5636,4854,4800,4752,3452,3095,3993,1643,0.291518808
A82025,10431,8771,8661,8557,6302,4601,8201,2230,0.213785831
A82026,17504,14735,14539,14352,10229,8076,13265,4239,0.242173218
A82027,10093,8695,8594,8508,6136,4916,7464,2629,0.260477559
A82028,8390,7364,7283,7188,5081,4393,6053,2337,0.278545888
A82029,3461,2966,2931,2888,2112,1838,2537,924,0.266974863
A82030,6252,5366,5305,5241,3731,3462,4402,1850,0.29590531
A82031,3053,2630,2602,2576,1916,1608,2268,785,0.25712414
A82032,13953,11560,11416,11275,7912,6105,10735,3218,0.230631405
A82033,8141,6851,6769,6689,4750,3965,6073,2068,0.254022847
A82034,6315,5454,5362,5252,3607,3525,4223,2092,0.331274743
A82035,14575,12443,12293,12152,8613,7034,10841,3734,0.25619211
A82036,10389,8829,8719,8657,6121,4876,7883,2506,0.241216671
A82037,4272,3738,3701,3673,2520,2367,2932,1340,0.313670412
A82038,4712,3908,3850,3800,2808,2273,3569,1143,0.242572156
A82039,8831,7462,7374,7295,5036,4059,6759,2072,0.234628015
A82041,10569,8757,8646,8534,6122,4606,8377,2192,0.207398997
A82044,24047,19884,19643,19399,13898,10336,19129,4918,0.204516156
A82045,8800,7312,7226,7126,5106,4036,6777,2023,0.229886364
A82046,5640,4921,4864,4827,3383,2247,4580,1060,0.187943262
A82047,9250,7716,7632,7558,5337,4132,7138,2112,0.228324324
A82048,6274,5143,5079,5013,3648,2637,5017,1257,0.200350653
A82049,5844,4774,4724,4679,3317,2420,4665,1179,0.20174538
A82050,6804,5576,5495,5436,3895,2880,5369,1435,0.21090535
A82053,5026,4488,4450,4422,3005,3100,3107,1919,0.381814564
A82055,6765,5627,5567,5499,3995,3246,5098,1667,0.246415373
A82058,4337,3666,3622,3588,2628,1966,3382,955,0.220198294
A82062,4774,3984,3938,3901,2726,2074,3764,1010,0.211562631
A82064,4944,4276,4227,4166,3079,2481,3689,1255,0.253843042
A82065,2862,2593,2573,2554,1686,1727,1829,1033,0.360936408
A82068,4442,3781,3726,3678,2638,2029,3435,1007,0.226699685
A82070,6185,5400,5308,5230,3647,3264,4391,1794,0.290056589
A82071,4331,3630,3587,3543,2551,1865,3381,950,0.21934888
A82072,6499,5371,5305,5248,3727,2794,5124,1375,0.211571011
A82075,6992,5767,5697,5631,4087,2985,5547,1445,0.20666476
A82077,5304,4340,4281,4218,2980,2125,4350,954,0.179864253
A82608,4344,3517,3370,3219,2286,2013,3266,1078,0.248158379
A82613,1030,906,896,887,642,524,740,290,0.281553398
A82617,2585,2160,2135,2108,1605,1335,1917,668,0.258413926
A82620,864,764,758,750,552,414,677,187,0.216435185
A82621,1280,1107,1093,1080,775,620,989,291,0.22734375
A82623,4983,4115,4058,4000,2915,2148,3893,1090,0.218743729
A82629,3139,2688,2665,2634,1921,1441,2446,693,0.220770946
A82631,3330,2845,2800,2767,2066,1685,2509,821,0.246546547
A82646,3472,2899,2868,2828,2083,1646,2629,843,0.242799539
A82647,2755,2446,2417,2387,1661,1630,1866,889,0.322686025
A82650,2818,2479,2453,2434,1810,1567,2003,815,0.289212207
A82651,3404,2926,2894,2862,2123,1821,2468,936,0.274970623
A82654,7672,6423,6348,6273,4446,3281,6180,1492,0.19447341
A83001,14354,11798,11657,11513,8474,5782,11492,2862,0.19938693
A83003,9257,7614,7492,7379,5489,4021,7302,1955,0.211191531
A83005,12018,9852,9708,9557,6868,5081,9467,2551,0.212264936
A83006,8091,6606,6519,6421,4573,3197,6617,1474,0.182177728
A83007,10111,8494,8395,8294,5818,4541,7849,2262,0.223716744
A83008,5515,4561,4502,4450,3133,2352,4343,1172,0.212511333
A83009,8226,7027,6935,6848,4784,3788,6244,1982,0.24094335
A83010,13692,11481,11320,11170,7915,6179,10489,3203,0.233932223
A83011,34042,32148,32047,31927,8959,5279,31223,2819,0.082809471
A83012,15943,13015,12835,12654,9113,6359,12943,3000,0.188170357
A83013,11794,9328,9190,9065,6536,4051,9943,1851,0.156944209
A83014,6781,5728,5657,5585,3975,3144,5159,1622,0.239197758
A83015,9994,8387,8293,8188,5819,4614,7595,2399,0.240044026
A83016,11071,9077,8966,8848,6415,4713,8817,2254,0.203594978
A83018,18521,15499,15303,15111,10815,8052,14476,4045,0.218400734
A83020,13413,10962,10811,10685,7774,5816,10501,2912,0.217102811
A83021,14734,11986,11795,11643,8476,5986,11780,2954,0.200488666
A83022,24594,20292,20035,19776,14466,10321,19628,4966,0.201919167
A83023,11782,9596,9461,9361,6643,4638,9487,2295,0.194788661
A83024,5544,4710,4652,4598,3339,2677,4137,1407,0.253787879
A83025,13305,10904,10752,10600,7742,5593,10754,2551,0.191732431
A83026,10347,8574,8461,8339,6082,4129,8335,2012,0.194452498
A83027,6462,5348,5269,5189,3770,2707,5231,1231,0.190498298
A83028,9504,8137,8048,7945,5756,4555,7284,2220,0.233585859
A83029,4966,4184,4120,4072,2952,2320,3801,1165,0.234595248
A83030,13467,11021,10883,10718,7705,4884,11188,2279,0.169228484
A83031,10490,8781,8636,8510,6184,4977,7955,2535,0.241658723
A83032,2510,2156,2120,2100,1470,1320,1775,735,0.292828685
A83033,9032,7495,7402,7318,5250,3836,7079,1953,0.216231178
A83034,10138,8220,8113,8004,5809,3898,8235,1903,0.187709607
A83035,7157,6243,6174,6108,4542,4029,5018,2139,0.298868241
A83036,11072,9335,9230,9123,6596,5492,7882,3190,0.288114162
A83037,13863,11656,11479,11340,7991,6540,10539,3324,0.23977494
A83038,5761,4596,4532,4477,3295,2231,4754,1007,0.174796042
A83040,11928,9679,9546,9411,6720,4390,9868,2060,0.172702884
A83041,7413,6126,6059,5990,4300,3158,5817,1596,0.21529745
A83043,2724,2372,2340,2316,1734,1555,1868,856,0.314243759
A83044,7495,6236,6161,6087,4259,3148,6038,1457,0.194396264
A83045,15036,12608,12433,12277,8755,6570,11795,3241,0.215549348
A83046,10659,9152,9029,8930,6309,5596,7674,2985,0.280045032
A83047,14971,12204,12028,11849,8365,5668,12247,2724,0.181951773
A83048,5643,4690,4619,4564,3393,2692,4214,1429,0.253234095
A83049,14032,11431,11278,11152,8102,5627,11391,2641,0.188212657
A83050,12571,10437,10314,10170,7473,5463,10011,2560,0.203643306
A83051,10534,8543,8444,8350,6009,4306,8402,2132,0.202392254
A83052,8714,7282,7181,7106,5258,3838,6715,1999,0.229400964
A83054,15600,12849,12653,12480,9166,6978,12151,3449,0.221089744
A83055,4474,3702,3661,3623,2657,2009,3339,1135,0.253687975
A83057,18211,15048,14856,14667,10339,7518,14585,3626,0.199110428
A83060,2976,2548,2515,2484,1878,1515,2273,703,0.236223118
A83061,3426,2922,2889,2853,2117,1808,2509,917,0.267659078
A83066,10819,8641,8515,8394,6115,3973,9054,1765,0.163138922
A83070,5624,4732,4666,4606,3388,2708,4233,1391,0.247332859
A83071,4794,3877,3821,3769,2768,1832,4022,772,0.161034627
A83072,4235,3491,3451,3406,2479,1987,3146,1089,0.257142857
A83073,5104,4243,4186,4153,2938,2281,3892,1212,0.237460815
A83074,11819,9548,9420,9301,6685,4659,9651,2168,0.183433455
A83075,8486,7073,6988,6905,4990,3556,6827,1659,0.195498468
A83610,3034,2434,2388,2355,1747,1139,2530,504,0.166117337
A83616,7865,6413,6329,6243,4549,3171,6395,1470,0.186904005
A83617,2615,2225,2195,2166,1578,1160,2073,542,0.207265774
A83618,7443,6143,6082,6018,4495,3231,5838,1605,0.215638855
A83619,3276,2630,2590,2555,1867,1169,2824,452,0.137973138
A83622,1644,1371,1356,1336,1028,758,1263,381,0.231751825
A83626,2059,1708,1688,1668,1244,923,1601,458,0.222438077
A83627,6002,4697,4637,4579,3389,1909,5207,795,0.132455848
A83630,2381,1981,1956,1920,1397,851,2008,373,0.156656867
A83632,2279,1940,1917,1898,1394,1082,1742,537,0.235629662
A83634,2762,2293,2270,2246,1638,1268,2115,647,0.234250543
A83635,4158,3316,3275,3239,2334,1272,3596,562,0.135161135
A83636,6025,4895,4840,4782,3488,2373,4938,1087,0.180414938
A83637,2119,1769,1748,1726,1296,936,1695,424,0.200094384
A83641,4765,3850,3798,3745,2777,1536,4128,637,0.133683106
A83644,3581,2910,2877,2848,2104,1442,2875,706,0.197151634
A84002,5852,5119,5071,5025,3707,3596,3830,2022,0.345522898
A84003,13709,11309,11177,11046,7885,5610,10922,2787,0.203297104
A84005,12063,9927,9784,9643,6894,5170,9515,2548,0.211224405
A84006,18548,16002,15800,15614,11202,9867,13225,5323,0.28698512
A84007,10043,8600,8492,8370,5858,5261,7144,2899,0.288658767
A84008,4493,4002,3968,3935,2829,2735,2955,1538,0.34231026
A84009,26595,21577,21264,21004,15058,10433,21523,5072,0.19071254
A84011,7598,6348,6257,6175,4367,3742,5551,2047,0.269413003
A84013,6199,5132,5062,5011,3576,2635,4903,1296,0.209065978
A84014,12710,10468,10323,10185,7209,5404,9905,2805,0.220692368
A84015,2426,1979,1957,1924,1411,952,1957,469,0.193322341
A84016,6846,5619,5531,5450,4004,2837,5547,1299,0.189745837
A84018,7004,6028,5958,5895,4210,3882,4853,2151,0.307110223
A84020,8083,6838,6761,6684,4706,3882,6091,1992,0.246443152
A84022,11933,10200,10090,9996,7214,6121,8760,3173,0.265901282
A84024,9805,8353,8244,8145,5739,4920,7211,2594,0.264558899
A84025,4909,4089,4044,3994,2982,2173,3734,1175,0.239356284
A84026,8961,7577,7474,7375,5241,4383,6492,2469,0.275527285
A84027,3364,2897,2859,2824,2114,1879,2410,954,0.283590963
A84028,17853,14836,14641,14459,10444,7651,14085,3768,0.211056965
A84029,2651,2218,2189,2168,1582,1275,1973,678,0.255752546
A84030,9550,8076,7968,7875,5565,4359,7054,2496,0.261361257
A84031,9753,8374,8276,8182,5900,5089,7054,2699,0.276735363
A84032,2410,2118,2099,2083,1497,1430,1624,786,0.326141079
A84033,6028,5140,5070,5014,3624,3102,4375,1653,0.274220305
A84034,5546,4711,4642,4598,3369,2946,3897,1649,0.29733141
A84035,6107,5191,5134,5064,3667,3047,4478,1629,0.266743082
A84036,19243,15882,15691,15503,11457,8776,14872,4371,0.227147534
A84037,5990,5109,5050,4996,3613,2726,4641,1349,0.225208681
A84038,6598,5528,5448,5396,3908,2953,4895,1703,0.258108518
A84039,5735,4893,4834,4778,3474,2888,4190,1545,0.269398431
A84040,3645,3161,3136,3106,2311,1986,2609,1036,0.284224966
A84042,2096,1837,1812,1796,1358,1154,1537,559,0.266698473
A84043,16929,13964,13757,13583,10275,7010,13619,3310,0.195522476
A84044,7233,6070,5992,5932,4274,3523,5331,1902,0.262961427
A84045,5349,4609,4546,4493,3331,2908,3866,1483,0.277248084
A84047,5348,4507,4446,4384,3284,2720,3924,1424,0.266267764
A84604,2236,1947,1935,1923,1410,1312,1515,721,0.322450805
A84609,1668,1432,1419,1407,1111,978,1143,525,0.314748201
A84614,1952,1627,1603,1576,1138,862,1518,434,0.222336066
A84619,3773,3193,3164,3120,2272,1615,2985,788,0.208852372
A85001,7770,6435,6341,6266,4562,3170,6238,1532,0.197168597
A85002,4130,3555,3517,3482,2514,1893,3237,893,0.21622276
A85003,6191,5303,5232,5169,3602,3169,4470,1721,0.277984171
A85004,10691,8817,8712,8592,6169,4412,8522,2169,0.202880928
A85005,16688,13962,13812,13661,9699,5992,13868,2820,0.168983701
A85006,9414,7812,7715,7626,5487,3671,7687,1727,0.183450181
A85007,8156,6791,6727,6665,4833,3616,6316,1840,0.225600785
A85008,15905,13147,12995,12811,9106,6792,12348,3557,0.223640365
A85009,6117,5112,5055,4979,3399,2432,4988,1129,0.184567598
A85010,11296,9351,9254,9146,6626,4671,9034,2262,0.200247875
A85011,8006,6483,6389,6315,4512,2950,6572,1434,0.179115663
A85012,3428,2989,2963,2928,2161,1525,2728,700,0.2042007
A85013,3886,3399,3373,3353,2124,1283,3310,576,0.148224395
A85014,6815,5818,5755,5694,4113,3247,5156,1659,0.243433602
A85016,10963,8928,8805,8695,6173,4328,8864,2099,0.191462191
A85017,6463,4748,4581,4348,2587,1542,5729,734,0.11356955
A85018,5050,4198,4148,4101,2894,2208,3932,1118,0.221386139
A85019,10808,9125,9034,8959,6511,3941,9170,1638,0.151554404
A85020,15815,13451,13296,13166,9325,7730,11290,4525,0.286120771
A85021,3657,3079,3033,2927,1124,665,3328,329,0.089964452
A85023,5675,4744,4700,4650,3476,1781,4952,723,0.127400881
A85024,2448,2086,2061,2047,1462,1088,1889,559,0.228349673
A85026,4787,3883,3834,3794,2723,1759,4022,765,0.159807813
A85611,5279,4354,4294,4227,3139,1985,4439,840,0.159121046
A85614,5590,4961,4936,4900,2781,1405,4985,605,0.10822898
A85616,4621,3924,3880,3834,2771,2250,3457,1164,0.25189353
A85617,3436,2809,2761,2724,1991,1392,2797,639,0.185972061
A85620,3968,3242,3202,3169,2235,1679,3082,886,0.22328629
A86003,39075,36727,36622,36499,12909,5203,36889,2186,0.055943698
A86004,15807,12367,12204,12048,8530,4048,13982,1825,0.115455178
A86005,6144,5034,4977,4931,3490,2181,5106,1038,0.168945313
A86006,5489,4697,4657,4605,3337,2379,4310,1179,0.214793223
A86007,2889,2648,2627,2611,1490,763,2558,331,0.114572516
A86008,12864,10402,10261,10133,7466,4626,10779,2085,0.162080224
A86010,9907,8376,8309,8228,5712,2826,8699,1208,0.121933986
A86011,10882,8912,8795,8674,6171,4100,8985,1897,0.174324573
A86012,9839,7576,7454,7331,5055,2550,8750,1089,0.11068198
A86013,7380,5965,5897,5816,4060,3020,5888,1492,0.202168022
A86016,9469,7952,7837,7744,5724,3722,7704,1765,0.186397719
A86017,10345,8450,8364,8260,5862,3419,8903,1442,0.13939101
A86018,12844,10771,10613,10478,7624,5754,9788,3056,0.237932108
A86020,13260,11901,11808,11716,6836,4273,11251,2009,0.151508296
A86021,9726,7935,7828,7733,5238,3805,7695,2031,0.208821715
A86022,8677,7165,7068,6980,4996,3749,6716,1961,0.22599977
A86023,8782,7436,7350,7268,5049,3111,7360,1422,0.161922113
A86024,7489,6357,6281,6224,4004,2038,6650,839,0.112030979
A86025,14510,11318,11149,10995,7776,4876,12363,2147,0.147966919
A86026,6480,5307,5242,5184,3655,2705,5091,1389,0.214351852
A86027,16143,15754,15741,15702,4015,561,15969,174,0.010778666
A86028,4106,3405,3378,3345,2546,1640,3293,813,0.198002923
A86029,20379,17781,17628,17487,9363,5582,17825,2554,0.12532509
A86030,11447,9026,8895,8757,6371,3786,9850,1597,0.139512536
A86031,9626,7589,7474,7352,4978,2661,8519,1107,0.115001039
A86033,6049,4385,4334,4286,3306,1625,5318,731,0.120846421
A86035,2583,2149,2124,2097,1532,945,2137,446,0.172667441
A86036,10458,8424,8328,8228,6033,3241,8914,1544,0.147638172
A86037,6523,5037,4941,4843,3432,1717,5831,692,0.106086157
A86038,5695,4758,4710,4666,3338,2406,4495,1200,0.21071115
A86040,6785,5201,5102,5005,3565,1954,6027,758,0.111717023
A86041,6075,5040,4979,4921,3600,2283,4945,1130,0.18600823
A86601,8891,7288,7192,7084,5113,3565,7201,1690,0.190079856
A87002,5751,5024,4968,4920,3559,2850,4330,1421,0.247087463
A87003,10769,9179,9079,8986,6486,4830,8464,2305,0.214040301
A87004,18701,15447,15266,15088,10912,7573,14999,3702,0.197957328
A87005,12584,10527,10398,10274,7506,5751,9481,3103,0.246582962
A87006,5877,5060,5020,4973,3547,2906,4234,1643,0.279564404
A87007,18810,15495,15297,15109,11068,7581,15155,3655,0.194311536
A87008,7787,6065,5972,5883,4434,2948,6268,1519,0.195068704
A87009,15436,12752,12621,12460,9523,6220,12584,2852,0.184762892
A87011,6955,5726,5658,5574,4096,3159,5329,1626,0.233788641
A87012,7702,6399,6315,6258,4455,3399,5917,1785,0.231757985
A87013,9530,7724,7615,7515,5437,3642,7814,1716,0.180062959
A87015,5905,5041,4983,4930,3551,2780,4440,1465,0.248094835
A87016,10929,9033,8937,8834,6477,4197,8925,2004,0.183365358
A87017,5462,4663,4604,4543,3206,2594,3961,1501,0.274807763
A87019,5167,4350,4303,4248,3007,2286,4069,1098,0.212502419
A87020,9080,7567,7459,7357,5434,4101,7000,2080,0.22907489
A87022,8464,6648,6550,6464,4886,2660,7331,1133,0.133861059
A87023,4983,4061,3996,3929,2889,1948,4035,948,0.190246839
A87029,9320,7439,7338,7257,5312,2910,8030,1290,0.138412017
A87030,5605,4246,4167,4107,2986,1582,5025,580,0.103479037
A87600,4724,3908,3855,3786,2722,1984,3724,1000,0.211685013
A87612,5841,4705,4645,4584,3424,2294,4752,1089,0.186440678
A87615,5046,4012,3961,3910,2927,1854,4066,980,0.194213238
A88001,3527,2965,2938,2911,2090,1446,2817,710,0.201304225
A88002,17361,14452,14255,14085,10159,6913,14176,3185,0.183457174
A88003,13779,11411,11260,11119,7714,5962,10696,3083,0.223746281
A88004,9351,7684,7576,7476,5504,3698,7662,1689,0.180622393
A88005,4474,3681,3625,3578,2649,1832,3632,842,0.18819848
A88006,7980,6615,6543,6477,4673,3491,6326,1654,0.20726817
A88007,7952,6964,6895,6826,5018,3378,6371,1581,0.198817907
A88008,6511,5599,5533,5466,3896,2655,5204,1307,0.200737214
A88009,6577,5533,5459,5390,3860,2915,5152,1425,0.216664133
A88010,3052,2613,2579,2545,1795,1509,2245,807,0.264416776
A88012,6521,5382,5306,5240,3817,2678,5267,1254,0.192301794
A88013,20201,16263,16049,15861,11403,7460,16695,3506,0.173555765
A88014,2775,2366,2338,2318,1627,867,2402,373,0.134414414
A88015,6615,5517,5450,5383,3926,2677,5375,1240,0.187452759
A88016,7985,6502,6405,6315,4598,3436,6232,1753,0.219536631
A88022,10376,8253,8133,8033,5903,3758,8739,1637,0.157767926
A88023,5140,4313,4260,4217,3036,2465,3873,1267,0.246498054
A88025,4990,4173,4122,4064,2934,2239,3903,1087,0.217835671
A88601,3509,3034,3016,2999,2177,1583,2718,791,0.225420348
A88608,5807,4927,4864,4824,3478,2515,4644,1163,0.20027553
A88613,4078,3379,3340,3309,2350,1709,3201,877,0.2150564
A89001,13513,11085,10958,10809,7764,5405,11009,2504,0.185303042
A89002,6094,5273,5213,5156,3459,2154,5158,936,0.153593699
A89004,11397,9508,9398,9287,6417,5012,8723,2674,0.234623146
A89005,5593,4732,4687,4620,3336,2638,4252,1341,0.239763991
A89006,7593,6280,6203,6112,4015,2527,6436,1157,0.15237719
A89007,10330,8658,8561,8466,5830,3995,8341,1989,0.192545983
A89008,5097,4182,4129,4071,2862,2003,4217,880,0.172650579
A89009,8763,7216,7125,7023,5031,3509,7150,1613,0.184069383
A89010,12464,10438,10307,10199,7248,5600,9630,2834,0.22737484
A89011,4320,3547,3491,3444,2455,1771,3488,832,0.192592593
A89012,10735,8681,8551,8443,6514,3998,8609,2126,0.198043782
A89013,5064,4524,4492,4451,2919,2378,3804,1260,0.248815166
A89015,9408,8081,7989,7886,5601,4715,6973,2435,0.258822279
A89016,8676,7524,7468,7393,5027,3559,6933,1743,0.200899032
A89017,13732,11460,11322,11178,7901,5274,11346,2386,0.173754733
A89018,5032,4268,4216,4174,2967,2081,4028,1004,0.199523052
A89019,10645,8736,8617,8503,6061,4380,8474,2171,0.203945514
A89020,9585,8092,8006,7911,5702,3585,7989,1596,0.166510172
A89021,8366,6906,6795,6710,4768,3516,6671,1695,0.202605785
A89022,5277,4455,4388,4317,3173,2317,4028,1249,0.236687512
A89023,7930,6579,6499,6415,4614,3462,6209,1721,0.21702396
A89024,5828,4851,4793,4733,3331,2495,4538,1290,0.22134523
A89025,12748,9979,9822,9664,7204,4134,10902,1846,0.144807029
A89026,7708,6421,6332,6258,4540,3284,6095,1613,0.209263103
A89027,6373,5073,5004,4942,3579,2409,5360,1013,0.158951828
A89028,7153,5900,5828,5737,4163,2973,5672,1481,0.207045995
A89030,6283,5180,5124,5054,3688,2628,4922,1361,0.216616266
A89031,5065,4269,4211,4166,2776,1692,4325,740,0.146100691
A89032,10320,8667,8545,8438,6044,4520,8145,2175,0.210755814
A89034,3943,3470,3433,3397,2450,1312,3471,472,0.119705808
A89035,8336,6839,6741,6669,4746,3440,6645,1691,0.202855086
A89036,2302,1935,1910,1889,1373,983,1869,433,0.188097307
A89040,4675,4120,4084,4051,2750,2149,3578,1097,0.234652406
A89041,6600,5203,5140,5081,3715,2226,5644,956,0.144848485
A89604,4395,3452,3402,3360,2396,1499,3802,593,0.134926052
A89614,4054,3291,3246,3200,2320,1518,3357,697,0.171928959
A89616,2293,1871,1856,1821,1388,940,1865,428,0.186655037
A89617,4049,3453,3415,3369,2431,1865,3158,891,0.220054334
A89623,2664,2243,2224,2197,1555,984,2172,492,0.184684685
B81002,3244,2551,2505,2458,1732,1090,2736,508,0.156596794
B81003,12119,10138,10017,9899,6858,5797,8882,3237,0.267101246
B81004,12608,10942,10799,10674,7637,7046,8437,4171,0.330821701
B81005,17033,14245,14075,13915,10112,7880,13041,3992,0.234368579
B81006,8387,7264,7187,7129,4787,4872,5362,3025,0.360677239
B81007,9739,8249,8138,8023,5794,4886,7167,2572,0.264092823
B81008,30474,24400,24065,23769,16987,11117,25367,5107,0.167585483
B81009,9473,7813,7697,7607,5610,4153,7330,2143,0.226221894
B81010,12491,10484,10344,10211,7133,5700,9417,3074,0.24609719
B81011,9742,7802,7683,7594,5369,3603,8086,1656,0.169985629
B81012,3488,2910,2879,2832,1992,1483,2796,692,0.198394495
B81013,8706,7061,6986,6906,4902,3046,7303,1403,0.161153228
B81014,6759,5690,5617,5552,3745,3491,4661,2098,0.310400947
B81015,14226,11694,11534,11385,8049,5911,11298,2928,0.205820329
B81016,9592,7706,7587,7476,5274,3559,7859,1733,0.180671393
B81017,15968,13252,13149,13011,9111,3821,14543,1425,0.089240982
B81018,9061,6922,6804,6684,4689,2850,7846,1215,0.13409116
B81020,7362,6042,5954,5877,4326,3119,5807,1555,0.211219777
B81022,13682,11523,11376,11240,7867,6526,10248,3434,0.250986698
B81023,6100,5014,4941,4887,3460,2645,4732,1368,0.224262295
B81024,8513,7273,7196,7105,4925,4574,5847,2666,0.313168096
B81025,35380,30113,29763,29454,21238,17858,25573,9807,0.277190503
B81026,20327,16531,16309,16086,11446,7250,16892,3435,0.168987062
B81027,8713,6930,6830,6748,4805,3151,7329,1384,0.158843108
B81029,10973,9176,9051,8914,6611,4953,8543,2430,0.221452657
B81030,13106,10889,10756,10609,7279,6336,9487,3619,0.276133069
B81031,12393,10181,10049,9903,7333,5171,10035,2358,0.1902687
B81032,4265,3682,3659,3632,2464,1097,3900,365,0.085580305
B81034,11218,9609,9509,9409,6888,6027,7864,3354,0.298983776
B81035,6867,5753,5682,5621,4040,2726,5539,1328,0.19338867
B81036,17161,14516,14330,14153,10217,8152,12980,4181,0.243633821
B81037,14969,12805,12648,12496,8814,7820,10613,4356,0.291001403
B81038,7501,6088,6002,5933,4252,3190,5860,1641,0.218770831
B81039,25335,20634,20370,20126,14390,10379,20330,5005,0.197552793
B81040,14513,11402,11215,11066,7893,4921,12420,2093,0.144215531
B81041,6141,5184,5101,5041,3671,2920,4641,1500,0.244259893
B81042,13117,11113,10996,10843,7616,6283,9615,3502,0.266981779
B81043,14929,12649,12505,12367,9001,7566,11095,3834,0.256815594
B81045,12686,10281,10113,9948,7093,5130,10059,2627,0.207078669
B81046,8499,6662,6572,6475,4537,3002,7207,1292,0.152017884
B81047,7337,6118,6043,5978,4409,2573,6276,1061,0.144609513
B81048,58597,47402,46753,46120,32448,21100,48765,9832,0.16779016
B81051,9927,8645,8542,8433,5942,5358,6971,2956,0.297773748
B81052,6725,5556,5493,5444,3956,1947,5984,741,0.110185874
B81054,8735,7511,7414,7320,5263,3674,6996,1739,0.199084144
B81055,4213,3599,3560,3528,2501,2083,3031,1182,0.280560171
B81058,8494,7066,6973,6902,4944,2979,7191,1303,0.153402402
B81060,6487,5602,5547,5492,3893,3401,4603,1884,0.290427008
B81061,27562,22634,22307,22019,16348,12128,21695,5867,0.21286554
B81063,6456,5531,5464,5415,3947,3362,4773,1683,0.260687732
B81064,9112,7428,7337,7255,5146,3689,7213,1899,0.208406497
B81065,11524,9645,9516,9394,6762,5344,8861,2663,0.231082957
B81068,17355,14212,14055,13867,9808,6919,13880,3475,0.200230481
B81069,10015,8396,8310,8217,5580,5149,6865,3150,0.314528208
B81070,6105,5106,5029,4969,3451,2993,4411,1694,0.277477477
B81074,6584,5385,5299,5219,3774,2576,5395,1189,0.180589307
B81075,3517,2979,2946,2920,2032,1626,2657,860,0.244526585
B81077,9829,8012,7905,7810,5613,4040,7948,1881,0.191372469
B81082,6211,5188,5098,5023,3747,2985,4780,1431,0.230397682
B81085,4685,3949,3911,3858,2754,2144,3632,1053,0.224759872
B81087,8695,7030,6910,6820,4984,3501,7003,1692,0.194594595
B81088,7374,6319,6230,6157,4643,3594,5661,1713,0.232302685
B81090,4486,3658,3601,3540,2525,1686,3721,765,0.170530539
B81091,5415,4468,4427,4392,3198,2322,4338,1077,0.198891967
B81092,10687,8907,8816,8726,6267,5120,7977,2710,0.253579115
B81095,4098,3510,3475,3443,2424,2058,2901,1197,0.292093704
B81097,2736,2235,2205,2191,1563,945,2271,465,0.16995614
B81099,10244,8568,8446,8343,6167,4934,7766,2478,0.241897696
B81100,4667,3865,3829,3794,2569,2171,3326,1341,0.287336619
B81101,21255,17890,17628,17375,12486,9963,16295,4960,0.233356857
B81104,7381,6980,6961,6932,1657,561,7209,172,0.023303075
B81108,4481,3676,3635,3591,2585,1817,3614,867,0.193483597
B81109,12796,10761,10622,10487,7513,6067,9642,3154,0.246483276
B81112,7898,6206,6110,6028,4313,2621,6696,1202,0.152190428
B81113,7640,6183,6094,6034,4264,2957,6256,1384,0.181151832
B81118,7998,6338,6242,6146,4313,3015,6524,1474,0.184296074
B81119,4737,3678,3622,3567,2492,1527,4128,609,0.128562381
B81603,2867,2253,2210,2169,1580,938,2476,391,0.136379491
B81606,4330,3408,3352,3297,2303,1423,3756,574,0.13256351
B81616,2765,2233,2202,2173,1489,1111,2249,516,0.186618445
B81617,8807,6746,6635,6510,4622,2285,7829,978,0.11104803
B81619,4261,3514,3467,3428,2452,1841,3308,953,0.223656419
B81620,2460,2047,2025,1992,1424,935,2023,437,0.177642276
B81628,3025,2540,2508,2480,1874,1519,2318,707,0.233719008
B81631,4653,3615,3562,3504,2586,1472,3954,699,0.150225661
B81635,3425,2908,2877,2847,2124,1641,2542,883,0.257810219
B81642,3892,3298,3264,3239,2334,1932,2800,1092,0.28057554
B81645,4016,3215,3180,3133,2273,1430,3407,609,0.151643426
B81647,3021,2495,2464,2440,1879,1384,2392,629,0.208209202
B81648,1502,1234,1222,1202,917,659,1238,264,0.175765646
B81653,7490,6403,6333,6263,4376,3504,5527,1963,0.262082777
B81655,2770,2155,2127,2094,1482,967,2343,427,0.154151625
B81656,6543,4804,4722,4651,3234,1850,5776,767,0.117224515
B81658,2797,2349,2316,2296,1722,1232,2260,537,0.191991419
B81663,2542,2077,2051,2028,1505,939,2110,432,0.169944925
B81664,1961,1512,1492,1474,1051,655,1668,293,0.149413565
B81665,2337,1911,1885,1854,1402,949,1915,422,0.180573385
B81666,2195,1917,1897,1878,1309,1176,1601,594,0.270615034
B81675,11196,8670,8555,8427,6045,3126,9941,1255,0.112093605
B81677,4189,3480,3435,3399,2449,1856,3272,917,0.21890666
B81688,2033,1581,1559,1542,1079,610,1771,262,0.128873586
B81697,2666,2112,2064,2040,1494,1021,2224,442,0.165791448
B82002,7244,6132,6051,5970,4199,3691,5251,1993,0.275124241
B82004,10318,8711,8604,8480,6212,5302,7611,2707,0.262357046
B82005,58719,47698,46974,46184,31859,19464,49722,8997,0.153221274
B82007,9512,8350,8223,8104,5720,5427,6548,2964,0.311606392
B82008,8515,7201,7104,6993,4969,4232,6177,2338,0.274574281
B82010,7338,6063,5985,5883,4155,3280,5653,1685,0.229626601
B82011,5425,4512,4457,4416,3289,2579,4199,1226,0.225990783
B82012,13912,11269,11086,10905,7976,6245,10776,3136,0.225416906
B82013,19952,16718,16524,16311,12019,8008,16324,3628,0.181836407
B82014,6708,5604,5534,5466,4040,2835,5269,1439,0.214519976
B82016,7757,6422,6331,6237,4635,3061,6289,1468,0.189248421
B82017,13884,11993,11841,11690,8447,7127,10040,3844,0.276865457
B82018,6171,5137,5025,4932,3666,2979,4662,1509,0.24453087
B82019,3284,2533,2498,2463,1887,1307,2646,638,0.194275274
B82020,12125,10037,9911,9774,7079,5560,9242,2883,0.237773196
B82021,8618,7344,7270,7200,5180,3550,6815,1803,0.209213275
B82022,5458,4696,4652,4590,3233,2995,3746,1712,0.31366801
B82023,6619,5340,5260,5175,3710,2758,5302,1317,0.198972654
B82024,8239,6591,6518,6417,4477,3465,6445,1794,0.217744872
B82025,20588,17181,16985,16810,12016,9171,15897,4691,0.227851175
B82026,32536,27433,27094,26788,18841,16018,23282,9254,0.284423408
B82027,15129,12679,12488,12282,8874,6329,12059,3070,0.202921541
B82028,14017,11904,11760,11605,8388,7084,10218,3799,0.271028037
B82029,3240,2842,2808,2774,2082,1805,2320,920,0.283950617
B82030,5708,4893,4851,4802,3498,3125,4038,1670,0.292571829
B82031,9941,8007,7905,7804,5685,3868,8161,1780,0.179056433
B82032,10708,8970,8868,8745,6360,5351,7994,2714,0.25345536
B82033,10580,9158,9060,8971,6287,5803,7183,3397,0.321077505
B82034,6173,5387,5320,5239,3775,3445,4365,1808,0.292888385
B82035,3597,3082,3040,3002,2184,1849,2667,930,0.258548791
B82036,7461,6182,6081,5976,4265,3358,5729,1732,0.232140464
B82037,9068,7840,7759,7676,5249,5190,5902,3166,0.349139832
B82038,29344,24401,24042,23711,16952,12546,23114,6230,0.21230916
B82041,16045,13347,13183,13015,9480,7277,12309,3736,0.232845123
B82042,8383,7086,6997,6932,4921,4094,6304,2079,0.248001909
B82044,9134,7946,7831,7711,5351,5121,6295,2839,0.310816729
B82045,4211,3736,3707,3679,2744,2484,2913,1298,0.308240323
B82046,2931,2491,2466,2435,1794,1512,2116,815,0.278062095
B82047,21900,20790,20727,20628,5816,2426,20712,1188,0.054246575
B82049,7168,6071,6000,5943,4217,3524,5296,1872,0.261160714
B82050,20075,17018,16829,16646,11910,10196,14530,5545,0.276214197
B82053,12831,10824,10701,10555,7715,5590,9987,2844,0.22165069
B82054,14298,12362,12230,12115,8588,7745,9821,4477,0.313120716
B82057,6379,5297,5228,5166,3834,2854,5099,1280,0.20065841
B82059,10866,9218,9100,8997,6493,4984,8340,2526,0.23246825
B82060,12217,10201,10090,9979,7011,5620,9193,3024,0.247523942
B82061,7096,6141,6079,6028,4299,3871,4967,2129,0.300028185
B82062,2430,2100,2075,2051,1544,1304,1756,674,0.277366255
B82063,8745,7530,7417,7328,5267,4875,5871,2874,0.32864494
B82064,3340,2807,2767,2724,2011,1619,2597,743,0.22245509
B82066,9613,8213,8116,8023,5738,4987,7013,2600,0.270467076
B82067,7455,6138,6050,5966,4361,3320,5782,1673,0.224413146
B82068,3454,2987,2951,2929,2048,1829,2410,1044,0.302258251
B82069,7383,6353,6273,6194,4421,3694,5505,1878,0.254368143
B82071,7507,6212,6118,6045,4469,3668,5532,1975,0.263087785
B82072,5546,4734,4672,4608,3436,2836,4019,1527,0.275333574
B82073,10048,8293,8183,8073,6049,4270,7911,2137,0.21267914
B82074,17452,14364,14181,14004,10068,7084,13947,3505,0.20083658
B82075,9646,8164,8050,7955,5764,4753,7169,2477,0.256790379
B82077,5931,5130,5072,5012,3543,3306,4079,1852,0.312257629
B82078,6069,5366,5322,5264,3721,3484,4076,1993,0.32839018
B82079,3513,3005,2962,2927,2055,1923,2434,1079,0.30714489
B82080,19430,16097,15889,15681,11409,9003,14688,4742,0.244055584
B82081,7138,5879,5792,5708,4215,3342,5495,1643,0.23017652
B82083,44273,37989,37600,37198,23631,14615,37505,6768,0.152869695
B82086,2403,2089,2066,2042,1488,1294,1747,656,0.272992093
B82088,10282,8665,8579,8468,5906,4393,8108,2174,0.211437464
B82091,7259,6117,6028,5950,4317,3094,5732,1527,0.210359554
B82097,10987,8854,8739,8621,6520,3792,9468,1519,0.138254301
B82098,21700,19001,18836,18672,12897,7347,18416,3284,0.151336406
B82100,8042,6799,6733,6650,4865,3574,6297,1745,0.216985824
B82101,5184,4492,4450,4410,3176,2889,3578,1606,0.309799383
B82103,2384,2087,2069,2048,1417,1051,1796,588,0.246644295
B82104,7979,5443,5335,5232,3608,1778,7354,625,0.078330618
B82105,8920,7390,7294,7207,5283,4033,6987,1933,0.216704036
B82106,3542,3041,2995,2960,2112,1908,2475,1067,0.301242236
B82609,3920,3267,3150,3001,2156,1876,2973,947,0.241581633
B82619,1347,1164,1157,1146,869,755,957,390,0.289532294
B82622,1593,1445,1432,1415,1054,987,1061,532,0.33396108
B82628,4036,3544,3501,3462,2412,2351,2704,1332,0.330029732
B83002,5088,4304,4245,4189,2966,2520,3664,1424,0.279874214
B83005,6896,4997,4884,4771,3352,1564,6275,621,0.090052204
B83006,11705,9747,9648,9545,6887,5302,8881,2824,0.241264417
B83008,12064,9300,9139,8969,6291,3610,10403,1661,0.137682361
B83009,10430,8455,8350,8240,5988,4217,8388,2042,0.1957814
B83010,10226,8089,7950,7832,5714,3500,8648,1578,0.154312537
B83012,10308,7709,7568,7423,5222,2872,9018,1290,0.125145518
B83014,13114,10913,10753,10631,7711,5602,10238,2876,0.21930761
B83015,8975,6732,6607,6484,4686,2640,7952,1023,0.113983287
B83016,7123,5227,5100,4993,3417,1783,6374,749,0.105152323
B83017,7932,6245,6146,6027,4392,2868,6710,1222,0.154059506
B83018,12157,9739,9586,9454,6866,4523,10051,2106,0.173233528
B83019,6842,5512,5446,5358,4036,2994,5276,1566,0.228880444
B83020,8328,6765,6673,6597,4873,3213,6989,1339,0.160782901
B83021,12946,10264,10107,9961,7107,4784,10715,2231,0.172331222
B83022,9199,7832,7737,7672,5679,4636,6667,2532,0.275247309
B83023,9904,7851,7718,7585,5327,3565,8203,1701,0.171748788
B83025,4320,3196,3134,3070,2200,1034,3899,421,0.097453704
B83026,5622,3907,3820,3725,2531,856,5332,290,0.051583067
B83027,9451,7960,7877,7772,5909,4441,7288,2163,0.22886467
B83028,10946,8856,8732,8603,6237,4388,8826,2120,0.193678056
B83029,10328,8321,8214,8106,5897,3998,8429,1899,0.183869094
B83030,8961,7243,7145,7058,5253,3597,7335,1626,0.181452963
B83031,3736,3101,3072,3046,2385,1657,2921,815,0.218147752
B83032,3981,2900,2834,2769,1969,926,3638,343,0.086159256
B83033,13401,10647,10481,10313,7456,4911,11218,2183,0.162898291
B83034,6818,4974,4829,4734,3264,1342,6253,565,0.082868877
B83035,10343,7539,7381,7212,5040,2256,9454,889,0.085951851
B83037,10085,8518,8417,8314,6063,4827,7572,2513,0.249181953
B83038,18827,14025,13712,13403,9256,5135,16554,2273,0.120730865
B83039,12789,10364,10244,10108,7458,5190,10348,2441,0.190867151
B83040,11514,9416,9298,9193,6818,4449,9293,2221,0.192895605
B83041,14736,11036,10821,10636,7686,4311,13013,1723,0.116924539
B83042,7830,5961,5886,5796,4139,2482,6733,1097,0.140102171
B83045,13818,10937,10757,10586,7582,5016,11479,2339,0.169271964
B83049,4581,3593,3495,3395,2406,1719,3731,850,0.185549007
B83051,9905,9144,9108,9079,4108,230,9872,33,0.003331651
B83052,23879,16973,16571,16151,11009,4906,21958,1921,0.080447255
B83054,5621,4603,4541,4482,3284,2128,4628,993,0.176658957
B83055,23786,17507,17158,16803,11689,6261,21153,2633,0.110695367
B83056,7862,6261,6163,6073,4220,2998,6391,1471,0.187102518
B83058,7235,4887,4750,4631,3009,966,6935,300,0.0414651
B83061,3535,2945,2913,2883,2152,1597,2791,744,0.210466761
B83062,8518,6456,6340,6240,4563,2569,7507,1011,0.118689833
B83063,19973,16040,15795,15555,11285,6686,16971,3002,0.150302909
B83064,10465,8039,7909,7777,5612,3525,8958,1507,0.144003822
B83067,7603,6302,6227,6149,4586,3289,5994,1609,0.211626989
B83602,6660,4747,4606,4473,2986,1109,6184,476,0.071471471
B83604,3103,2248,2189,2137,1475,591,2871,232,0.074766355
B83611,7208,5306,5193,5082,3527,1219,6772,436,0.060488346
B83614,9124,6449,6304,6159,4097,1524,8472,652,0.071459886
B83617,2509,1808,1773,1728,1186,436,2308,201,0.080111598
B83620,3065,2671,2649,2629,1857,1858,1914,1151,0.375530179
B83621,4166,3018,2958,2877,1993,779,3857,309,0.074171867
B83622,5102,3666,3579,3479,2407,913,4809,293,0.057428459
B83624,17830,15161,14941,14748,10183,9216,12929,4901,0.274873808
B83626,6508,4549,4445,4316,2859,1086,6077,431,0.066226183
B83627,3764,2883,2828,2771,2006,921,3368,396,0.105207226
B83628,8802,6566,6436,6299,4327,1364,8316,486,0.055214724
B83629,3035,2213,2173,2127,1506,782,2724,311,0.10247117
B83641,7806,5549,5401,5248,3466,1359,7216,590,0.075582885
B83642,3273,2401,2346,2292,1585,625,3043,230,0.070271922
B83653,9182,6442,6269,6104,4159,1487,8659,523,0.056959268
B83657,5417,4356,4307,4244,2827,543,5348,69,0.012737678
B83659,3181,2309,2232,2162,1411,532,2985,196,0.061615844
B83660,5841,4280,4179,4089,2865,1023,5478,363,0.062146893
B83661,2908,2140,2078,2015,1321,588,2699,209,0.071870702
B84001,10013,8094,7997,7894,5913,3590,8450,1563,0.156097074
B84003,8529,7168,7083,6995,5031,3847,6733,1796,0.210575683
B84004,18814,15787,15581,15375,11935,8675,14965,3849,0.204581694
B84005,10486,8633,8500,8389,5993,4362,8306,2180,0.207896243
B84006,13627,11130,10978,10845,8033,5826,10822,2805,0.205841344
B84007,10628,8714,8576,8445,6457,4520,8635,1993,0.187523523
B84008,15547,12872,12680,12506,9158,6840,12148,3399,0.218627388
B84009,11368,9278,9140,9021,6825,4792,9096,2272,0.199859254
B84010,10461,8450,8320,8198,5838,4008,8590,1871,0.178854794
B84011,11629,9855,9713,9581,6888,5315,8898,2731,0.234843925
B84012,19654,15016,14710,14447,9980,5396,17175,2479,0.126132085
B84013,8919,7210,7099,7016,5080,3574,7285,1634,0.183204395
B84014,4787,4078,4035,3992,2832,2423,3442,1345,0.280969292
B84016,10377,8418,8304,8176,5876,4061,8474,1903,0.183386335
B84019,15278,11749,11561,11364,8144,4469,13252,2026,0.13260898
B84021,8405,6927,6859,6771,4720,3566,6641,1764,0.209875074
B84612,8366,6654,6555,6449,4663,2536,7261,1105,0.132082238
B84613,9039,6880,6766,6679,4729,2672,7974,1065,0.117822768
B84618,8997,7123,7017,6923,5046,3065,7715,1282,0.142491942
B84623,4470,3609,3550,3499,2547,1586,3780,690,0.154362416
B85001,7746,6340,6263,6188,4456,3152,6219,1527,0.197134005
B85002,4096,3304,3252,3210,2345,1711,3257,839,0.204833984
B85004,5645,4481,4412,4349,3141,1896,4815,830,0.147032772
B85005,6625,5501,5426,5370,4023,3131,4943,1682,0.253886792
B85006,14665,12431,12246,12040,8933,7092,11294,3371,0.22986703
B85008,5346,4166,4111,4040,2805,1622,4591,755,0.141227086
B85009,8682,6834,6729,6621,4606,2983,7196,1486,0.171158719
B85010,6643,5348,5273,5202,3667,2607,5423,1220,0.183651964
B85012,10980,8582,8458,8342,6122,3894,9195,1785,0.162568306
B85014,9500,7891,7770,7674,5473,4062,7397,2103,0.221368421
B85015,8963,7347,7243,7152,5173,3561,7224,1739,0.194019859
B85016,10036,7716,7581,7442,5393,3057,8654,1382,0.137704265
B85018,9150,7251,7133,7012,4923,3017,7733,1417,0.154863388
B85019,17418,14465,14270,14090,9997,7641,13378,4040,0.231943966
B85020,6679,5260,5178,5112,3682,2231,5760,919,0.137595448
B85021,9652,8070,7979,7888,5628,4198,7571,2081,0.215602984
B85022,7676,6480,6383,6312,4568,3771,5679,1997,0.260161542
B85023,6527,5346,5282,5207,3713,2679,5196,1331,0.203922169
B85024,9531,7757,7649,7559,5454,3948,7484,2047,0.214772847
B85025,11945,9624,9487,9373,6767,4707,9698,2247,0.188112181
B85026,8144,6701,6598,6485,4886,3600,6344,1800,0.221021611
B85027,11071,8958,8835,8730,6438,4345,8997,2074,0.187336284
B85028,15614,11947,11735,11534,8295,5249,13143,2471,0.158255412
B85030,8104,6455,6355,6261,4534,2876,6739,1365,0.168435341
B85031,7008,5912,5824,5741,4052,3346,5339,1669,0.238156393
B85032,6314,5175,5105,5020,3642,2769,4878,1436,0.227431105
B85033,4979,4025,3968,3916,2837,1965,4006,973,0.195420767
B85036,7518,6029,5943,5851,4290,2904,6171,1347,0.179169992
B85037,6211,5075,5011,4933,3494,2373,5063,1148,0.18483336
B85038,5886,4854,4789,4718,3313,2487,4747,1139,0.193510024
B85041,15116,11194,10940,10666,7433,3408,13780,1336,0.08838317
B85042,8546,6673,6559,6447,4706,2771,7381,1165,0.136321086
B85044,2605,1853,1801,1753,1221,479,2445,160,0.061420345
B85048,3660,2740,2691,2647,1873,942,3302,358,0.097814208
B85051,8960,7277,7173,7083,5222,3645,7284,1676,0.187053571
B85054,10111,8371,8252,8170,6215,4465,7973,2138,0.211452873
B85055,10770,7677,7504,7318,4988,1828,10094,676,0.062766945
B85058,2366,2006,1990,1967,1419,755,2070,296,0.125105664
B85059,6159,4976,4912,4859,3672,2258,5217,942,0.152946907
B85060,2540,2200,2185,2167,1514,1270,1782,758,0.298425197
B85061,9354,7798,7705,7610,5566,4335,7139,2215,0.236797092
B85062,15479,14513,14481,14440,3699,360,15416,63,0.00407003
B85606,4840,3803,3729,3651,2575,1551,4132,708,0.146280992
B85610,9964,8036,7928,7811,6052,4100,8053,1911,0.191790446
B85611,3910,3103,3046,2984,2147,1154,3417,493,0.126086957
B85612,3577,2845,2812,2777,1977,1261,3000,577,0.161308359
B85614,5306,3991,3912,3826,2693,1151,4856,450,0.084809649
B85619,2895,2198,2158,2117,1495,804,2529,366,0.12642487
B85620,1982,1638,1612,1593,1141,778,1585,397,0.200302725
B85622,3671,2971,2920,2874,2028,1401,2987,684,0.186325252
B85623,3051,2461,2430,2395,1726,1013,2617,434,0.142248443
B85634,3400,2504,2460,2421,1740,744,3125,275,0.080882353
B85636,3837,3160,3112,3067,2134,1576,3053,784,0.204326297
B85638,3101,2570,2538,2498,1828,1253,2558,543,0.175104805
B85640,3187,2625,2584,2543,1941,1242,2636,551,0.172889865
B85641,4753,3948,3886,3844,2700,1965,3779,974,0.204923206
B85645,2653,1809,1764,1707,1118,388,2511,142,0.053524312
B85646,6437,5139,5063,4971,3487,2162,5386,1051,0.163274817
B85650,4443,3129,3039,2960,2020,606,4253,190,0.042763898
B85652,7760,5637,5492,5342,3698,1559,7147,613,0.078994845
B85655,2446,1904,1862,1834,1263,800,2061,385,0.157399836
B85659,1566,1283,1272,1262,749,117,1551,15,0.009578544
B85660,5902,4763,4696,4642,3299,2220,4932,970,0.164351067
B86001,2467,2098,2070,2049,1466,906,2023,444,0.179975679
B86002,15193,11713,11542,11377,8049,3501,13820,1373,0.090370565
B86003,15422,12130,11980,11830,8456,4010,13817,1605,0.104072105
B86004,8054,6606,6516,6439,4608,3264,6349,1705,0.211696052
B86005,5442,4285,4210,4142,2944,1495,4858,584,0.107313488
B86006,15594,12782,12600,12455,8878,6310,12531,3063,0.196421701
B86007,8380,6637,6542,6466,4609,3023,7001,1379,0.164558473
B86008,15298,12005,11851,11687,8716,5804,12443,2855,0.186625703
B86009,8241,6875,6806,6734,4626,3439,6336,1905,0.231161267
B86010,9561,7899,7789,7691,5625,4705,7034,2527,0.264302897
B86011,6870,5410,5330,5236,3771,2435,5702,1168,0.170014556
B86012,17047,13107,12873,12665,9037,4220,15444,1603,0.094034141
B86013,21456,15583,15302,15044,10672,4408,19598,1858,0.086595824
B86014,13366,10592,10451,10313,7660,4421,11275,2091,0.156441718
B86015,14505,11632,11469,11306,8072,4815,12417,2088,0.143950362
B86016,17442,13675,13459,13272,9359,5904,14682,2760,0.158238734
B86017,10804,9643,9573,9499,4857,2242,9748,1056,0.097741577
B86018,7520,6272,6202,6126,4422,3201,5921,1599,0.212632979
B86019,9226,7114,7024,6931,5234,2413,8214,1012,0.109690007
B86020,11037,9025,8914,8801,6500,4402,8922,2115,0.19162816
B86022,13843,10725,10546,10371,7246,4053,12080,1763,0.127356787
B86023,3711,3078,3046,3002,2241,1643,2817,894,0.240905416
B86024,8809,7301,7216,7130,5140,3400,7284,1525,0.173118402
B86025,10196,8770,8708,8630,4681,1513,9670,526,0.051588858
B86028,4409,3726,3698,3667,2547,1623,3650,759,0.172147879
B86029,5638,4652,4593,4531,3443,2446,4408,1230,0.218162469
B86030,11691,10436,10374,10290,5787,3638,9723,1968,0.168334616
B86031,4332,3232,3176,3127,2164,1046,4007,325,0.075023084
B86032,19042,15924,15724,15513,11293,9093,14243,4799,0.252021846
B86033,11812,10024,9926,9816,6815,5949,8406,3406,0.28835083
B86034,6721,5419,5355,5271,3846,3059,4975,1746,0.25978277
B86035,7145,5690,5607,5531,4056,2306,6142,1003,0.140377887
B86036,11393,9418,9322,9215,6689,5091,8602,2791,0.244974985
B86038,11965,9782,9656,9530,6951,4738,9544,2421,0.202340159
B86039,5869,5096,5060,5017,3633,2109,4813,1056,0.179928438
B86041,7120,5836,5762,5691,3712,1934,6294,826,0.116011236
B86042,15377,11791,11599,11435,8310,4566,13477,1900,0.123561163
B86043,8511,6447,6345,6254,4326,2604,7258,1253,0.147221243
B86044,26010,20771,20513,20265,14340,9311,21100,4910,0.188773549
B86048,13813,11542,11397,11262,7846,6025,10582,3231,0.233910085
B86049,8708,6848,6755,6677,4570,2200,7826,882,0.101286174
B86050,19757,15777,15597,15404,11507,6646,16705,3052,0.154476894
B86051,14521,11860,11688,11511,8528,5786,11767,2754,0.18965636
B86052,10853,8843,8733,8623,6355,4775,8316,2537,0.233760251
B86054,6196,4933,4858,4775,3347,2200,5217,979,0.158005165
B86055,6760,5546,5471,5403,3891,2733,5386,1374,0.203254438
B86056,4825,4040,4003,3963,2878,2046,3775,1050,0.21761658
B86057,17051,13980,13810,13650,10012,6428,14038,3013,0.176705179
B86058,4207,3546,3515,3471,2519,1726,3424,783,0.186118374
B86059,14266,11592,11455,11323,8176,4456,12318,1948,0.136548437
B86060,9651,7859,7760,7660,5336,3200,8178,1473,0.152626671
B86061,4224,3220,3162,3082,2098,722,3942,282,0.066761364
B86062,8719,7180,7087,6995,5114,3632,6973,1746,0.200252323
B86064,16311,13272,13101,12923,9407,6385,13505,2806,0.172031145
B86066,13753,11015,10862,10724,8062,4992,11183,2570,0.18686832
B86067,16065,12992,12834,12679,9520,5770,13433,2632,0.163834423
B86068,7847,6557,6486,6414,4494,2968,6359,1488,0.189626609
B86069,12943,11583,11508,11435,6515,2381,11990,953,0.073630534
B86070,4156,3506,3461,3416,2458,1865,3171,985,0.237006737
B86071,8667,6855,6746,6654,4836,2763,7537,1130,0.130379601
B86074,5771,4619,4555,4498,3391,1913,4845,926,0.16045746
B86075,13065,10621,10479,10356,7364,4854,10789,2276,0.174205894
B86081,14572,10318,10113,9872,6906,3108,13491,1081,0.074183365
B86086,7970,7329,7299,7275,3423,1486,7287,683,0.085696361
B86089,5861,4799,4741,4669,3357,2351,4692,1169,0.199454018
B86092,6310,5201,5136,5067,3673,2598,5105,1205,0.190966719
B86093,5610,4438,4376,4306,3103,2088,4541,1069,0.190552585
B86094,4946,3980,3925,3873,2736,1681,4193,753,0.152244238
B86096,5561,4431,4372,4314,3137,1849,4783,778,0.139902895
B86100,6928,5809,5753,5690,4244,2285,6072,856,0.123556582
B86101,3395,2824,2804,2770,1987,1431,2628,767,0.225920471
B86103,3269,2343,2284,2236,1530,592,3066,203,0.062098501
B86104,13331,9911,9712,9548,6934,3162,12119,1212,0.09091591
B86106,6893,5046,4918,4816,3373,1741,6256,637,0.092412592
B86108,5319,4021,3941,3859,2728,1114,4962,357,0.067117879
B86109,7224,6286,6238,6203,3801,1349,6706,518,0.071705426
B86110,43841,43477,43471,43395,3287,46,43837,4,9.12E-05
B86623,4645,3264,3200,3143,2098,542,4516,129,0.027771798
B86625,3983,3379,3331,3298,2335,1871,2969,1014,0.254581973
B86633,2345,1954,1935,1912,1387,827,1971,374,0.159488273
B86642,2539,2086,2061,2033,1339,688,2240,299,0.117762899
B86643,3523,2534,2467,2409,1648,556,3311,212,0.060175986
B86648,2196,1977,1956,1944,1335,1227,1553,643,0.2928051
B86654,5036,3920,3871,3823,2819,1495,4331,705,0.139992057
B86655,1828,1527,1507,1494,1146,666,1551,277,0.151531729
B86658,10327,8509,8397,8283,6007,4201,8184,2143,0.207514283
B86666,4679,3681,3620,3559,2505,1127,4241,438,0.093609746
B86667,7376,5586,5509,5445,3811,1644,6764,612,0.0829718
B86669,1792,1712,1702,1685,1256,257,1758,34,0.018973214
B86672,6017,4772,4723,4664,3353,1849,5217,800,0.132956623
B86673,3475,2905,2872,2837,2148,1666,2657,818,0.235395683
B86675,4240,3342,3295,3253,2348,1055,3856,384,0.090566038
B86678,2915,2407,2368,2332,1727,1167,2348,567,0.194511149
B87001,8682,7255,7156,7054,5273,3888,6809,1873,0.215733702
B87002,11242,9405,9266,9164,6710,4995,8716,2526,0.224693115
B87003,10026,8285,8190,8096,5974,4410,7839,2187,0.218132855
B87004,10566,8531,8416,8314,5854,3320,9075,1491,0.141113004
B87005,11458,9424,9310,9193,6750,4459,9422,2036,0.177692442
B87006,10701,8644,8542,8443,5951,4191,8712,1989,0.185870479
B87007,12801,10312,10162,10039,7166,4518,10679,2122,0.165768299
B87008,14096,11201,11028,10872,7643,5145,11582,2514,0.178348468
B87009,6443,5375,5307,5251,3701,2788,5069,1374,0.213254695
B87011,13466,11082,10952,10812,7691,5763,10593,2873,0.213352146
B87012,9139,7258,7153,7053,5061,2998,7803,1336,0.146186673
B87013,13353,11116,10976,10843,7961,5895,10373,2980,0.223170823
B87015,8911,7428,7325,7234,5188,3700,7107,1804,0.202446415
B87016,22961,18563,18268,18022,13019,8391,19194,3767,0.164060799
B87017,23505,19569,19341,19137,13698,8414,19665,3840,0.163369496
B87018,10585,8604,8478,8387,6068,4038,8744,1841,0.173925366
B87019,7451,6221,6156,6099,4473,3150,6067,1384,0.18574688
B87020,13590,11288,11143,11008,8059,6045,10418,3172,0.233406917
B87021,11955,9683,9543,9414,6784,4782,9621,2334,0.19523212
B87022,8128,6154,6061,5958,4256,2048,7282,846,0.104084646
B87025,6447,5391,5327,5279,3643,2473,5260,1187,0.184116643
B87026,14677,11955,11794,11631,8223,5759,11958,2719,0.185255842
B87027,13704,11285,11147,11017,8241,5404,11173,2531,0.184690601
B87028,10817,8856,8739,8630,6234,4566,8578,2239,0.206988999
B87030,27358,22013,21689,21415,15438,10277,22683,4675,0.170882374
B87031,13713,11153,11010,10898,7886,5481,10833,2880,0.210019689
B87032,7502,6025,5950,5876,4180,2629,6356,1146,0.152759264
B87033,3963,3313,3265,3224,2341,1638,3234,729,0.183951552
B87036,4236,3505,3462,3422,2507,1745,3429,807,0.190509915
B87039,15289,12329,12179,12025,8757,5147,13087,2202,0.144025116
B87040,7672,6299,6183,6098,4531,3118,6148,1524,0.198644421
B87041,2332,1941,1922,1894,1388,913,1941,391,0.167667238
B87042,5350,4161,4082,4027,2974,1687,4691,659,0.12317757
B87044,2771,2347,2314,2289,1681,1164,2228,543,0.195958138
B87600,2583,2198,2176,2159,1581,1162,1996,587,0.22725513
B87602,2506,2110,2083,2062,1505,1094,1973,533,0.212689545
B87604,2422,1919,1886,1847,1304,740,2100,322,0.132947977
C81001,10778,8963,8880,8786,6263,4625,8477,2301,0.213490443
C81002,12483,10521,10387,10272,7268,5718,9440,3043,0.243771529
C81003,10501,8955,8861,8754,6548,4863,8120,2381,0.22674031
C81004,10713,9060,8957,8848,6291,4994,8062,2651,0.247456361
C81005,16937,14061,13929,13777,9940,7282,13236,3701,0.218515676
C81006,20687,16691,16460,16257,11518,6632,17882,2805,0.135592401
C81007,9977,8266,8160,8062,5470,3313,8303,1674,0.167785908
C81008,9803,8171,8081,7993,5620,4453,7471,2332,0.237886361
C81009,14901,12562,12412,12284,8847,4828,12948,1953,0.131065029
C81010,12696,10782,10663,10545,7428,5664,9876,2820,0.222117202
C81012,15270,12761,12607,12474,8971,6447,11985,3285,0.215127701
C81013,4741,4108,4054,4010,2857,2691,3259,1482,0.31259228
C81014,10970,8843,8720,8584,6005,4141,8829,2141,0.195168642
C81015,11516,9618,9522,9420,6684,5236,8726,2790,0.242271622
C81016,5818,5038,4975,4915,3402,3192,4040,1778,0.3056033
C81017,8880,7421,7339,7271,5373,3993,6912,1968,0.221621622
C81018,8782,7453,7363,7276,5267,4375,6554,2228,0.253700752
C81020,10574,8674,8490,8294,5848,4380,8409,2165,0.204747494
C81021,15269,12343,12168,12019,8541,5901,12413,2856,0.187045648
C81022,3548,2966,2928,2897,2016,1584,2699,849,0.239289741
C81023,8865,7462,7356,7272,5246,4012,6765,2100,0.236886633
C81025,10277,8565,8444,8318,5997,4772,7693,2584,0.251435244
C81026,7112,5963,5895,5832,4143,3051,5666,1446,0.203318335
C81027,7567,6279,6200,6104,4410,3096,6084,1483,0.195982556
C81028,7656,6577,6502,6431,4694,4024,5458,2198,0.287095089
C81029,16886,13803,13623,13450,9629,7082,13398,3488,0.206561649
C81030,8261,7105,7026,6953,4924,4415,5798,2463,0.298147924
C81031,8773,7182,7080,6995,5032,3569,7049,1724,0.196512026
C81032,13931,11584,11430,11275,8073,5761,11000,2931,0.210394085
C81033,16181,13147,12964,12789,8883,6096,13408,2773,0.171373834
C81034,9614,8019,7921,7813,5487,4118,7641,1973,0.205221552
C81035,11259,8978,8834,8695,6221,3931,9322,1937,0.172040146
C81036,4656,4026,3996,3964,2652,1768,3723,933,0.200386598
C81037,8684,7385,7303,7209,5201,4186,6599,2085,0.24009673
C81038,12669,10615,10489,10350,7541,5644,9925,2744,0.21659168
C81039,3430,2984,2942,2904,2110,1882,2468,962,0.280466472
C81040,6607,5484,5412,5346,3832,3197,4879,1728,0.26154079
C81041,11271,9154,9022,8910,6518,4606,9023,2248,0.199449916
C81042,11465,9601,9464,9349,6706,5363,8654,2811,0.245180986
C81044,7988,6676,6597,6526,4662,3490,6392,1596,0.1997997
C81045,13832,11715,11595,11460,8069,6169,10870,2962,0.214141122
C81046,4723,4030,3985,3955,2832,2375,3415,1308,0.276942621
C81047,10814,9134,9030,8914,6206,5130,8099,2715,0.251063436
C81048,11061,9219,9073,8914,6293,5384,8190,2871,0.259560618
C81049,9864,8178,8075,7961,5694,3975,7945,1919,0.194545823
C81050,9624,7868,7783,7694,5484,3890,7724,1900,0.197423109
C81051,25797,22085,21874,21663,11456,7849,21947,3850,0.14924216
C81052,7365,6089,6001,5910,4274,2959,5956,1409,0.191310251
C81053,10092,8366,8286,8187,6016,4272,8010,2082,0.206302021
C81054,21398,16468,16196,15942,11642,6408,18566,2832,0.132348818
C81055,3777,3183,3141,3092,2181,1613,2939,838,0.221869208
C81056,6144,5153,5078,5022,3506,2837,4584,1560,0.25390625
C81057,9154,7658,7573,7460,5550,4325,6972,2182,0.238365742
C81058,8294,6891,6802,6707,4740,3514,6495,1799,0.216903786
C81059,5337,4470,4422,4376,3081,2407,4126,1211,0.226906502
C81060,9834,8055,7941,7843,5660,3878,8078,1756,0.178564165
C81061,15325,12727,12582,12439,9019,6200,12336,2989,0.195040783
C81062,8779,7512,7423,7338,5421,4550,6447,2332,0.265633899
C81063,9160,7606,7497,7404,5402,4324,6981,2179,0.237882096
C81064,12343,10184,10053,9934,6871,5108,9572,2771,0.224499716
C81065,7497,6270,6181,6109,4294,3244,5954,1543,0.20581566
C81066,10811,9118,8993,8860,6332,4948,8298,2513,0.232448432
C81067,9176,7838,7735,7648,5573,4766,6639,2537,0.276482127
C81068,13226,10684,10529,10381,7269,5130,10641,2585,0.195448359
C81069,13506,11524,11398,11265,8309,6385,10345,3161,0.234044129
C81070,4494,3943,3893,3855,2560,2508,3024,1470,0.327102804
C81071,15337,12491,12299,12124,8488,5038,13052,2285,0.148986112
C81072,27172,20430,20052,19668,13564,6875,24493,2679,0.098594141
C81073,11275,9523,9430,9337,6472,3894,9317,1958,0.173658537
C81074,8296,6967,6885,6794,4792,3684,6517,1779,0.214440694
C81075,5907,5062,4994,4940,3591,3242,4200,1707,0.288979177
C81076,3311,2839,2798,2755,2053,1731,2479,832,0.2512836
C81077,3439,2867,2837,2815,2079,1475,2746,693,0.201512067
C81080,8603,7209,7122,7029,5220,4100,6634,1969,0.228873649
C81081,13737,11416,11271,11140,8167,5827,10983,2754,0.200480454
C81082,3019,2645,2613,2587,1914,1650,2218,801,0.265319642
C81083,10951,9060,8972,8875,6319,4403,8917,2034,0.185736462
C81084,19751,16560,16387,16224,11849,8459,15600,4151,0.210166574
C81086,8136,6864,6755,6644,4756,3857,6207,1929,0.237094395
C81087,11472,8798,8648,8503,6118,3477,10017,1455,0.126830544
C81089,5096,4290,4246,4200,2879,2482,3659,1437,0.281985871
C81090,3787,3220,3185,3148,2234,1700,2963,824,0.21758648
C81091,9068,7673,7590,7514,5474,3969,7226,1842,0.203131892
C81092,5872,5123,5055,4994,3576,3290,4117,1755,0.298876022
C81094,7517,6469,6409,6350,4689,4151,5276,2241,0.298124252
C81095,4697,3828,3767,3712,2714,1805,3852,845,0.179902065
C81096,5425,4471,4420,4373,3203,2366,4222,1203,0.221751152
C81097,6278,5131,5063,4985,3635,2506,5104,1174,0.18700223
C81099,7847,6690,6597,6518,4682,3538,6092,1755,0.223652351
C81101,8213,6891,6811,6729,4928,3808,6210,2003,0.243881651
C81106,6460,5308,5230,5161,3901,2570,5371,1089,0.168575851
C81108,15351,12456,12256,12079,8912,6307,12401,2950,0.192169891
C81110,10800,8483,8329,8204,6057,3707,9149,1651,0.15287037
C81113,6234,5093,5032,4958,3649,2472,4885,1349,0.216393969
C81114,12425,9761,9643,9515,7169,4008,10879,1546,0.124426559
C81115,5000,4237,4184,4143,2811,2197,3917,1083,0.2166
C81118,7883,5896,5767,5663,4015,1939,7079,804,0.101991628
C81604,3611,2929,2883,2852,2060,1418,2939,672,0.186098034
C81611,2252,1996,1972,1958,1376,1316,1537,715,0.31749556
C81615,2170,1721,1699,1679,1169,746,1853,317,0.146082949
C81616,5050,3704,3613,3524,2424,1105,4558,492,0.097425743
C81634,4023,3357,3335,3303,2502,1732,3236,787,0.195625155
C81638,3544,2970,2937,2906,2072,1475,2874,670,0.189051919
C81640,3820,3108,3061,3018,2306,1534,3118,702,0.183769634
C81642,5204,4154,4108,4057,3080,1645,4533,671,0.128939277
C81647,4478,3812,3770,3733,2701,2172,3409,1069,0.238722644
C81648,4452,3729,3697,3666,2670,1678,3741,711,0.159703504
C81649,7254,5955,5885,5806,4193,3096,5839,1415,0.195064792
C81652,4459,3784,3757,3726,2738,1415,3919,540,0.121103386
C81653,4214,3383,3341,3314,2421,1345,3601,613,0.145467489
C81655,3452,2986,2962,2927,2066,1763,2514,938,0.271726535
C81658,6041,5043,4988,4921,3567,2755,4580,1461,0.241847376
C81660,3364,2765,2729,2706,2025,1385,2755,609,0.181034483
C81661,2605,2163,2132,2109,1480,1148,2032,573,0.219961612
C81662,7557,6263,6146,6044,4448,3182,6092,1465,0.193859997
C82001,26601,21520,21178,20881,15525,11214,21014,5587,0.210029698
C82002,10930,8942,8828,8713,6366,4719,8509,2421,0.221500457
C82003,11596,9581,9419,9269,6619,4888,9147,2449,0.211193515
C82005,9556,7581,7468,7354,5259,3082,8173,1383,0.144725827
C82007,9860,8326,8225,8138,5991,4492,7643,2217,0.22484787
C82008,8969,6915,6805,6709,4729,3041,7544,1425,0.158880589
C82009,25214,21095,20780,20451,14529,11243,19405,5809,0.23038788
C82010,16013,13290,13059,12804,8829,7354,11864,4149,0.25910198
C82011,11561,9442,9318,9208,6417,3982,9573,1988,0.171957443
C82012,11149,9064,8942,8845,6373,4621,8850,2299,0.206206835
C82013,11274,9314,9198,9071,6309,4866,8605,2669,0.2367394
C82014,17805,14474,14225,14013,10321,7342,14123,3682,0.206795844
C82016,6989,5811,5717,5654,4213,3358,5405,1584,0.226641866
C82017,14512,12048,11887,11734,8731,6591,11261,3251,0.224021499
C82018,15613,12492,12288,12114,9023,5297,13254,2359,0.151092039
C82019,5135,4024,3971,3924,2831,1788,4318,817,0.159104187
C82020,23335,22297,22259,22196,4942,1107,23051,284,0.012170559
C82021,9147,7447,7352,7237,4969,3840,7175,1972,0.215589811
C82022,7038,5932,5851,5781,4167,3574,5148,1890,0.268542199
C82024,21197,17371,17107,16791,12125,6647,18449,2748,0.129640987
C82025,10883,9134,8994,8856,6439,5019,8321,2562,0.235413029
C82026,8355,7016,6917,6797,4743,3379,6651,1704,0.203949731
C82027,7722,6228,6152,6074,4464,3219,6023,1699,0.22002072
C82028,7165,6054,5977,5905,4149,3510,5252,1913,0.266992324
C82029,11892,9422,9276,9146,6442,4652,9554,2338,0.196602758
C82030,6829,5728,5628,5554,3842,3146,5130,1699,0.248791917
C82031,13684,10116,9915,9732,7134,3336,12389,1295,0.094636071
C82032,7472,6086,6022,5953,4302,3199,5782,1690,0.22617773
C82033,10758,8139,8007,7860,5550,3240,9301,1457,0.135434096
C82034,9223,7627,7460,7214,5218,3827,7297,1926,0.208825762
C82035,7558,6312,6223,6123,4348,2839,6130,1428,0.188938873
C82037,10518,8826,8711,8603,6226,4034,8541,1977,0.187963491
C82038,35767,29618,29267,28920,20765,15629,27836,7931,0.221740711
C82039,10522,8414,8302,8202,5943,3687,8795,1727,0.164132294
C82040,8625,7559,7475,7404,4538,3285,7040,1585,0.183768116
C82041,12609,10386,10215,10019,6971,4576,10355,2254,0.178761202
C82042,12793,10615,10475,10326,7414,5584,9881,2912,0.227624482
C82043,12304,10239,10117,9987,6990,5225,9552,2752,0.2236671
C82044,7084,5842,5777,5713,4205,3480,5271,1813,0.255928854
C82045,6752,5485,5398,5341,3829,2537,5576,1176,0.174170616
C82046,17283,13339,13105,12873,9141,5425,14923,2360,0.136550367
C82047,10202,8552,8441,8333,6138,4323,8182,2020,0.198000392
C82048,4526,3728,3679,3632,2540,1982,3401,1125,0.248563853
C82050,14066,11622,11466,11309,8076,5684,11238,2828,0.201052183
C82051,11297,9416,9304,9179,6749,5488,8359,2938,0.260069045
C82052,4085,3430,3393,3356,2431,1852,3113,972,0.237943696
C82053,10916,8156,7980,7821,5616,3324,9581,1335,0.122297545
C82054,11065,9223,9098,8998,6553,4997,8340,2725,0.246272029
C82055,14644,12158,11977,11829,8605,6347,11593,3051,0.208344715
C82056,14055,11577,11424,11256,8086,6226,10724,3331,0.23699751
C82059,1523,1241,1229,1216,815,375,1337,186,0.12212738
C82060,4340,3109,3039,2943,2106,900,4001,339,0.078110599
C82061,13498,10794,10658,10527,7822,4744,11316,2182,0.161653578
C82062,8433,7017,6913,6826,5127,3927,6455,1978,0.234554725
C82063,12146,9660,9478,9301,6461,3697,10578,1568,0.129095999
C82064,11799,9919,9782,9674,6925,5123,9142,2657,0.225188575
C82066,15010,12202,12035,11915,8474,6048,11837,3173,0.211392405
C82067,9263,7467,7360,7264,5220,3880,7285,1978,0.213537731
C82068,11982,9967,9846,9718,6775,5339,9137,2845,0.237439493
C82070,9769,8079,7965,7866,5613,3565,7998,1771,0.181287747
C82071,12480,10330,10187,10051,6978,5353,9692,2788,0.223397436
C82072,7895,6445,6351,6276,4509,3146,6341,1554,0.196833439
C82073,14787,11547,11366,11230,8070,4119,13112,1675,0.113275174
C82075,10457,8694,8589,8491,6188,4515,8149,2308,0.220713398
C82076,7413,6183,6093,6013,4532,3846,5435,1978,0.266828544
C82077,11411,9436,9143,8838,6318,5420,8606,2805,0.245815441
C82078,12173,10134,10002,9870,7097,5254,9558,2615,0.214819683
C82079,8087,6541,6446,6370,4469,3220,6540,1547,0.19129467
C82080,4893,3709,3648,3578,2503,1212,4409,484,0.09891682
C82082,5488,4616,4563,4513,3189,2335,4229,1259,0.229409621
C82084,3311,2669,2628,2590,1892,1074,2889,422,0.127453941
C82086,8889,6927,6842,6736,4823,2308,7997,892,0.100348746
C82088,8890,7203,7087,6967,5083,2956,7613,1277,0.143644544
C82091,8073,6288,6214,6139,4357,2712,6819,1254,0.15533259
C82092,3561,2919,2894,2868,2114,1219,2990,571,0.160348217
C82093,11696,9499,9348,9196,6835,4808,9580,2116,0.180916553
C82094,6888,5258,5161,5076,3761,2020,6073,815,0.118321719
C82095,9488,7711,7611,7501,5449,3873,7668,1820,0.191821248
C82096,8316,6596,6501,6403,4678,2840,7055,1261,0.151635402
C82097,1733,1433,1417,1410,1068,692,1394,339,0.195614541
C82098,7519,6196,6094,6012,4308,3147,5965,1554,0.20667642
C82099,4255,3212,3166,3105,2199,1147,3845,410,0.096357227
C82100,6080,4600,4516,4436,3122,1871,5213,867,0.142598684
C82102,4460,3730,3679,3628,2800,2154,3430,1030,0.230941704
C82103,7692,6206,6136,6077,4624,2923,6333,1359,0.176677067
C82105,3016,2022,1969,1915,1340,533,2854,162,0.053713528
C82107,7809,6188,6088,5979,4322,2128,6942,867,0.11102574
C82109,3916,3299,3253,3217,2363,1931,2944,972,0.248212462
C82111,17638,17295,17280,17258,2158,187,17600,38,0.002154439
C82112,4037,3303,3248,3189,2274,1625,3281,756,0.187267773
C82114,2405,1992,1965,1949,1379,638,2139,266,0.110602911
C82116,3729,2991,2923,2869,1994,984,3307,422,0.113167069
C82119,2211,1814,1791,1770,1314,688,1918,293,0.132519222
C82120,3553,2991,2952,2915,2169,1601,2738,815,0.229383619
C82121,14604,12096,11954,11822,8541,6014,11632,2972,0.203505889
C82122,5550,4613,4564,4514,3234,1943,4688,862,0.155315315
C82124,23647,22170,22110,22036,7161,1673,23118,529,0.022370702
C82600,5804,4686,4607,4541,3270,2026,4899,905,0.155926947
C82610,6093,4258,4150,4064,2940,1429,5494,599,0.098309536
C82611,6123,4982,4904,4834,3543,2503,4983,1140,0.186183244
C82614,4065,3178,3123,3074,2226,1375,3396,669,0.164575646
C82620,1796,1503,1491,1477,1110,508,1615,181,0.10077951
C82623,3592,2855,2807,2761,2126,1168,3107,485,0.135022272
C82624,7015,4951,4836,4724,3302,1394,6508,507,0.072273699
C82626,2312,1804,1784,1753,1260,744,1984,328,0.141868512
C82627,5547,4404,4331,4289,3183,1977,4606,941,0.169641248
C82628,3621,2971,2938,2911,2162,1525,2860,761,0.210162938
C82631,6750,5260,5182,5111,3834,2166,5891,859,0.127259259
C82634,3910,3180,3136,3105,2268,1468,3272,638,0.163171355
C82639,7409,6121,6047,5985,4151,2319,6325,1084,0.146308544
C82642,10013,7807,7655,7531,5333,2556,9050,963,0.096174973
C82643,13073,9491,9289,9073,6228,2685,12045,1028,0.078635355
C82644,4296,3354,3310,3269,2456,1475,3637,659,0.15339851
C82649,4611,3861,3817,3775,2839,2392,3334,1277,0.276946432
C82650,4686,3669,3601,3546,2640,1838,3779,907,0.193555271
C82651,4042,3313,3263,3209,2301,1304,3449,593,0.14670955
C82653,1519,1257,1243,1225,845,342,1396,123,0.080974325
C82656,2390,1940,1920,1901,1366,995,1856,534,0.223430962
C82659,2711,2114,2075,2039,1445,658,2503,208,0.076724456
C82660,6206,5014,4949,4865,3527,1927,5348,858,0.138253303
C82662,5220,4327,4298,4255,2685,831,4960,260,0.049808429
C82667,7527,5704,5587,5478,3802,1993,6686,841,0.111731101
C82669,4164,3330,3274,3227,2295,1151,3691,473,0.113592699
C82670,974,973,973,970,733,154,960,14,0.014373717
C82671,5160,4087,4030,3974,2902,1206,4722,438,0.084883721
C82676,5532,4244,4160,4094,2895,1856,4566,966,0.17462039
C82678,7143,5804,5731,5651,4114,2638,5856,1287,0.180176396
C82680,4626,3760,3707,3654,2569,1760,3765,861,0.18612192
C83001,11443,9565,9467,9356,6559,3367,10084,1359,0.118762562
C83002,8361,6759,6665,6576,4590,3963,6223,2138,0.255711039
C83003,19148,15631,15464,15288,10724,6814,15665,3483,0.181898893
C83004,11689,9669,9551,9410,6645,4540,9401,2288,0.195739584
C83005,7352,6242,6164,6104,4252,3912,5120,2232,0.30359086
C83007,31765,26310,25944,25590,18643,13949,24564,7201,0.226696049
C83008,6485,4959,4871,4801,3475,2141,5440,1045,0.161141095
C83009,9429,7495,7381,7296,5034,3283,7840,1589,0.168522643
C83010,16480,13300,13140,12983,9389,5496,13883,2597,0.157584951
C83011,10800,8823,8688,8570,6084,4818,8321,2479,0.229537037
C83013,7834,6601,6518,6443,4479,4003,5653,2181,0.278401838
C83014,10206,8203,8091,7981,5549,3803,8324,1882,0.184401333
C83015,8566,7320,7218,7141,5060,4423,6099,2467,0.287999066
C83018,12680,10116,9960,9826,6929,4854,10296,2384,0.188012618
C83019,21653,18507,18305,18093,12861,11221,15331,6322,0.29196878
C83020,9352,7881,7764,7670,5574,4761,6948,2404,0.257057314
C83022,20409,16863,16671,16462,11639,7881,16366,4043,0.198098878
C83023,17491,14565,14332,14132,10039,7866,13450,4041,0.231033103
C83024,3348,2873,2832,2794,2087,1725,2483,865,0.258363202
C83025,11728,9563,9438,9305,6438,4702,9271,2457,0.209498636
C83026,23865,19852,19572,19298,14307,11472,17982,5883,0.246511628
C83027,9304,7925,7827,7751,5378,4840,6609,2695,0.289660361
C83028,7944,6680,6603,6528,4506,3759,5911,2033,0.255916415
C83029,5582,4638,4570,4497,3170,2627,4232,1350,0.2418488
C83030,4835,4046,3998,3944,2802,2433,3548,1287,0.266184074
C83031,11909,10104,9975,9877,6889,6275,8118,3791,0.318330674
C83032,7471,6417,6335,6270,4398,4123,5072,2399,0.321108285
C83033,3474,2957,2923,2894,2083,1808,2531,943,0.27144502
C83035,12397,10104,9960,9815,7002,5360,9571,2826,0.227958377
C83036,7135,5954,5883,5821,4153,3590,5173,1962,0.274982481
C83037,9497,7717,7591,7470,5388,4166,7391,2106,0.221754238
C83038,8013,6814,6738,6674,4801,4064,5832,2181,0.272182703
C83039,5600,4846,4794,4740,3399,3129,3900,1700,0.303571429
C83040,15594,13079,12931,12774,8786,6633,12006,3588,0.230088496
C83041,8008,6605,6515,6420,4429,3303,6200,1808,0.225774226
C83042,6110,5334,5273,5220,3762,3513,4120,1990,0.325695581
C83043,10483,8871,8755,8649,6165,5289,7628,2855,0.272345703
C83044,11355,9027,8915,8794,6083,4331,9176,2179,0.191897842
C83045,16905,14324,14158,13991,9926,8515,12230,4675,0.276545401
C83046,5953,4887,4807,4739,3447,2315,4926,1027,0.172518058
C83048,14389,11518,11369,11214,8035,5133,11848,2541,0.176593231
C83049,6694,5769,5704,5635,3991,3606,4700,1994,0.297878697
C83051,7579,6270,6198,6138,4317,2019,6781,798,0.105290935
C83052,3404,2858,2824,2783,2078,1642,2658,746,0.219153937
C83053,2338,1988,1971,1951,1441,1146,1748,590,0.252352438
C83054,12452,10130,10006,9881,7035,5388,9594,2858,0.229521362
C83055,5559,4762,4699,4643,3385,3005,3962,1597,0.287281885
C83056,14603,12344,12197,12060,8774,7385,10603,4000,0.273916319
C83057,7275,5735,5664,5587,3902,2787,5836,1439,0.197800687
C83058,7556,6449,6368,6297,4461,4038,5210,2346,0.310481736
C83059,12600,10207,10070,9939,7104,4391,10546,2054,0.163015873
C83060,17357,14022,13857,13665,9618,6034,14474,2883,0.166100133
C83061,9721,8356,8261,8168,5891,5243,6834,2887,0.296985907
C83062,5618,4570,4508,4456,3193,2562,4274,1344,0.239231043
C83063,16077,13569,13423,13252,9243,8130,11490,4587,0.285314424
C83064,13958,12407,12304,12201,8514,8959,8252,5706,0.408797822
C83065,6951,5860,5809,5741,3996,3305,5087,1864,0.268162854
C83067,6011,5110,5026,4961,3693,3331,4249,1762,0.293129263
C83071,7090,5998,5911,5826,4195,3145,5478,1612,0.227362482
C83072,10487,8397,8271,8152,5829,4189,8428,2059,0.196338324
C83073,6206,5169,5103,5048,3580,2014,5324,882,0.142120529
C83074,4140,3603,3569,3521,2615,2322,2929,1211,0.292512077
C83075,8129,6714,6630,6535,4718,3510,6407,1722,0.211834174
C83078,9651,7994,7895,7781,5502,3802,7816,1835,0.190135737
C83079,5141,4145,4099,4063,2950,1752,4352,789,0.153472087
C83080,6026,4792,4716,4651,3441,2325,4971,1055,0.175074676
C83082,9796,7926,7807,7704,5499,3656,7974,1822,0.185994283
C83083,8044,6484,6395,6327,4495,3623,6164,1880,0.23371457
C83085,12214,10082,9931,9805,6903,5580,9243,2971,0.243245456
C83611,6582,5194,5110,5048,3820,2438,5431,1151,0.17487086
C83613,5187,4357,4305,4246,3060,2595,3893,1294,0.249469828
C83614,3581,3088,3041,3004,2205,1819,2620,961,0.268360793
C83617,7734,6364,6274,6192,4646,3438,6056,1678,0.216964055
C83626,8032,6677,6611,6559,4429,2100,7222,810,0.100846614
C83631,2840,2279,2244,2214,1603,944,2399,441,0.15528169
C83634,4087,3508,3482,3449,2253,2384,2570,1517,0.371176902
C83635,5739,4944,4898,4843,3418,3203,3904,1835,0.319742115
C83637,5912,4900,4824,4743,3237,2635,4452,1460,0.246955345
C83641,4362,3832,3794,3764,2662,2577,2836,1526,0.349839523
C83643,2223,1918,1896,1879,1390,1235,1572,651,0.292847503
C83649,4823,4022,3957,3901,2940,2322,3707,1116,0.23139125
C83650,3675,3105,3054,3025,2127,1893,2609,1066,0.290068027
C83653,3715,3132,3076,3027,2266,1873,2860,855,0.230148048
C84001,30132,24075,23732,23385,16824,11786,24403,5729,0.190130094
C84004,7363,5649,5566,5475,3934,2392,6336,1027,0.13948119
C84005,14454,11846,11706,11568,8265,6427,10942,3512,0.242977722
C84008,4801,4030,3981,3928,2889,2453,3507,1294,0.269527182
C84009,13783,11227,11078,10946,7837,5447,11011,2772,0.201117318
C84010,11701,9564,9447,9319,6748,4289,9792,1909,0.163148449
C84011,9091,7581,7483,7402,5398,3810,7210,1881,0.206907931
C84012,14054,11740,11589,11427,7923,6025,11026,3028,0.215454675
C84013,13780,11564,11428,11308,8126,6372,10509,3271,0.237373004
C84014,10237,8418,8286,8196,6018,4176,8372,1865,0.18218228
C84016,13176,10920,10805,10682,7644,5932,10079,3097,0.235048573
C84017,24847,20184,19927,19683,14422,10615,19316,5531,0.222602326
C84018,11070,8824,8724,8600,6222,3145,9813,1257,0.113550136
C84019,13519,11225,11094,10970,7788,5865,10499,3020,0.223389304
C84020,6688,5605,5550,5505,3868,2485,5562,1126,0.168361244
C84021,12901,10605,10464,10344,7376,5393,10253,2648,0.205255407
C84023,46490,45574,45547,45461,9311,824,46171,319,0.006861691
C84024,30349,25639,25338,25031,17644,12695,24137,6212,0.204685492
C84025,7121,5995,5921,5843,4276,3532,5348,1773,0.248981885
C84026,11979,10017,9874,9757,7012,5499,8956,3023,0.252358294
C84028,6908,5580,5521,5458,3991,2749,5532,1376,0.199189346
C84029,19354,15980,15785,15607,11049,7249,15905,3449,0.178206056
C84030,10689,8843,8734,8640,6054,3590,8846,1843,0.172420245
C84031,2765,2332,2304,2284,1660,1087,2236,529,0.191320072
C84032,19537,16548,16390,16232,11474,9544,14268,5269,0.269693402
C84033,8173,6838,6768,6709,4828,3637,6181,1992,0.243729353
C84034,9269,7632,7537,7445,5401,3546,7763,1506,0.162477074
C84035,12053,10148,10041,9930,6976,5718,9011,3042,0.252385298
C84036,15985,13011,12870,12709,9197,5907,13330,2655,0.166093212
C84037,12126,10195,10061,9933,7173,5723,9098,3028,0.249711364
C84039,12113,10272,10181,10087,6790,3642,10502,1611,0.132997606
C84042,7422,5983,5911,5842,4150,2900,5992,1430,0.192670439
C84043,9417,7190,7085,6969,4813,3012,7957,1460,0.15503876
C84044,10349,8264,8155,8061,5793,4290,8013,2336,0.225722292
C84045,7280,6233,6166,6074,4430,3878,5141,2139,0.293818681
C84046,8171,6488,6383,6304,4335,2980,6748,1423,0.174152491
C84047,9685,8082,7981,7899,5712,4569,7202,2483,0.256375839
C84048,10879,9246,9127,9016,6297,5643,7652,3227,0.296626528
C84049,12445,10634,10478,10325,6927,6297,8998,3447,0.276978706
C84051,19668,15743,15529,15331,11184,7128,16304,3364,0.171039252
C84053,15834,12696,12551,12395,8913,5859,13005,2829,0.178666161
C84055,11905,9663,9522,9385,6529,4693,9512,2393,0.20100798
C84057,3563,2963,2921,2887,2154,1528,2799,764,0.214426045
C84059,16202,13042,12853,12678,9167,6283,13336,2866,0.176891742
C84060,9082,7315,7224,7116,4998,3425,7480,1602,0.176392865
C84061,8927,6961,6874,6781,4872,2820,7662,1265,0.14170494
C84063,9287,7174,7046,6921,4920,2570,8220,1067,0.114891784
C84064,7857,6040,5938,5860,3991,2425,6687,1170,0.148911798
C84065,5368,4341,4286,4230,2880,1930,4356,1012,0.18852459
C84066,9584,7823,7724,7639,5487,3961,7581,2003,0.208994157
C84067,6046,5101,5054,4994,3567,2800,4579,1467,0.242639762
C84069,13338,10894,10775,10663,7709,5212,10763,2575,0.19305743
C84072,9937,7556,7422,7312,5218,2680,8876,1061,0.106772668
C84074,4285,3496,3455,3417,2442,1741,3433,852,0.198833139
C84076,4103,3389,3338,3301,2378,1665,3324,779,0.189861077
C84077,9305,7571,7480,7401,5346,3713,7463,1842,0.197958087
C84078,13318,10548,10401,10262,7535,4375,11398,1920,0.144165791
C84080,12966,11007,10911,10832,7645,5340,10251,2715,0.209393799
C84081,6327,5068,4989,4919,3500,2442,5148,1179,0.186344239
C84084,8177,6829,6745,6663,4678,4128,5779,2398,0.293261587
C84085,9846,8418,8343,8261,5887,3368,8441,1405,0.142697542
C84086,12034,9521,9405,9296,6850,4035,9898,2136,0.177497092
C84087,6031,4989,4923,4855,3462,2541,4814,1217,0.201790748
C84090,9846,8194,8071,7944,5849,4028,8131,1715,0.174182409
C84091,8212,6265,6139,6006,4198,2530,7091,1121,0.13650755
C84092,4475,3659,3606,3560,2498,1272,3958,517,0.115530726
C84094,18955,15545,15330,15169,10830,8188,14876,4079,0.21519388
C84095,7280,6006,5936,5854,4166,2995,5827,1453,0.199587912
C84096,3367,2679,2628,2592,1799,1052,2914,453,0.134541135
C84101,3259,2821,2799,2778,2035,1700,2337,922,0.282908868
C84103,4412,3456,3404,3338,2436,1156,3992,420,0.095194923
C84105,7374,5462,5364,5268,3747,1567,6822,552,0.074857608
C84106,8196,6840,6781,6697,4662,3342,6448,1748,0.213274768
C84107,7807,6661,6583,6481,4608,3699,5846,1961,0.251184834
C84112,3563,2969,2930,2909,2119,1631,2706,857,0.240527645
C84113,6601,5623,5551,5496,3923,3231,4868,1733,0.262535979
C84114,9027,7360,7272,7189,5131,3790,7171,1856,0.205605406
C84115,7373,6138,6061,5991,4373,3071,5912,1461,0.198155432
C84116,8850,6925,6798,6697,4773,2965,7496,1354,0.15299435
C84117,22418,21743,21705,21627,3575,987,22078,340,0.015166384
C84120,15254,12335,12184,12017,8750,6095,12243,3011,0.197390848
C84122,8839,6987,6871,6760,4843,3116,7264,1575,0.178187578
C84123,3432,2859,2822,2782,2068,1557,2651,781,0.227564103
C84127,4556,3700,3658,3614,2596,1893,3650,906,0.198858648
C84129,7501,6118,6037,5965,4295,3039,5922,1579,0.210505266
C84131,7465,6045,5970,5898,4373,3120,5954,1511,0.202411253
C84135,4090,3307,3248,3202,2240,1438,3471,619,0.151344743
C84136,4126,3358,3315,3267,2220,1043,3756,370,0.08967523
C84138,2554,2064,2041,2000,1474,900,2191,363,0.142129992
C84140,5078,4311,4260,4208,3045,2356,3935,1143,0.225088618
C84142,4974,4149,4093,4026,2923,2223,3866,1108,0.222758343
C84144,3950,2999,2946,2908,1984,926,3594,356,0.090126582
C84150,3916,3261,3224,3180,2222,1671,3111,805,0.205566905
C84151,2565,2025,1994,1961,1442,633,2311,254,0.099025341
C84605,16917,13903,13647,13441,9907,6855,13773,3144,0.185848555
C84613,2321,1970,1946,1926,1399,1269,1643,678,0.292115467
C84619,6724,5345,5273,5211,3749,2137,5796,928,0.138013087
C84621,4498,3458,3406,3357,2442,1104,4001,497,0.110493553
C84624,5121,4267,4214,4144,3171,2171,4174,947,0.184924819
C84628,6550,5000,4929,4842,3398,1237,6138,412,0.062900763
C84629,4261,3465,3419,3376,2358,1594,3529,732,0.171790659
C84637,6096,4921,4850,4781,3420,2237,5120,976,0.160104987
C84646,7130,6082,6021,5933,4235,3743,5071,2059,0.288779804
C84647,1537,1284,1267,1252,890,732,1141,396,0.257644763
C84654,4087,3343,3293,3247,2390,1730,3282,805,0.19696599
C84656,3241,2674,2637,2599,1973,1351,2729,512,0.157975933
C84658,6029,4859,4788,4725,3343,2451,4875,1154,0.191408194
C84660,4267,3610,3560,3512,2623,2136,3185,1082,0.25357394
C84664,4482,3724,3698,3654,2697,1368,3929,553,0.123382419
C84667,4968,4143,4096,4044,2931,2000,3998,970,0.195249597
C84676,6743,5261,5184,5104,3612,1306,6312,431,0.063918137
C84679,3348,2749,2718,2687,1917,949,2984,364,0.108721625
C84680,4904,3375,3287,3218,2271,1045,4546,358,0.073001631
C84682,4725,3963,3922,3875,2930,1572,4118,607,0.128465608
C84683,9351,7569,7476,7389,5230,2305,8487,864,0.092396535
C84691,8864,6451,6294,6173,4390,1379,8455,409,0.046141697
C84692,2603,2245,2216,2192,1559,1463,1812,791,0.303880138
C84693,5447,4410,4351,4292,3117,2049,4489,958,0.175876629
C84694,3746,2851,2799,2751,1914,1162,3211,535,0.142819007
C84695,3546,2729,2676,2628,1870,956,3156,390,0.10998308
C84696,5563,4527,4469,4418,3353,2134,4581,982,0.176523459
C84703,5890,4596,4505,4431,3365,2015,5086,804,0.136502547
C84704,5676,4444,4382,4304,3114,1805,4875,801,0.141120507
C84705,6174,4946,4873,4804,3408,2178,5154,1020,0.165208941
C84709,10163,8169,8069,7958,5779,3821,8445,1718,0.169044573
C84710,2801,2240,2217,2196,1561,1083,2273,528,0.188504106
C84714,6578,6572,6569,6567,573,39,6574,4,0.000608088
C84717,2997,2378,2332,2304,1662,1011,2558,439,0.146479813
C85001,4393,3652,3613,3574,2534,1837,3510,883,0.201001593
C85003,12196,9718,9586,9478,6562,4435,10029,2167,0.177681207
C85004,17113,14137,13947,13802,10272,7934,13127,3986,0.23292234
C85005,7900,6522,6435,6340,4518,3327,6277,1623,0.205443038
C85006,5030,4265,4229,4181,3041,2275,3854,1176,0.233797217
C85007,10444,8727,8620,8499,5992,4494,8262,2182,0.208923784
C85008,13024,10756,10620,10494,7681,5653,10296,2728,0.209459459
C85009,6725,5410,5351,5281,3768,1829,5993,732,0.108847584
C85010,17073,14105,13908,13744,9980,7333,13358,3715,0.217595033
C85013,10526,8448,8334,8235,5814,3884,8628,1898,0.180315409
C85014,8876,7294,7189,7093,5146,3639,7126,1750,0.197160883
C85016,12020,9701,9576,9434,6846,4832,9636,2384,0.198336106
C85017,11472,9522,9411,9295,6557,4605,9148,2324,0.202580195
C85018,6802,5307,5231,5163,3629,2442,5610,1192,0.175242576
C85019,5205,4388,4347,4306,3168,2172,4194,1011,0.194236311
C85020,13681,11547,11420,11299,8169,5873,10761,2920,0.21343469
C85022,12214,10055,9900,9782,6993,5011,9885,2329,0.190682823
C85023,11000,8934,8810,8693,6155,4349,8956,2044,0.185818182
C85024,6231,5234,5177,5107,3721,2823,4870,1361,0.218424009
C85026,5091,4339,4287,4243,3027,2401,3834,1257,0.246906305
C85028,4426,3770,3723,3672,2606,1843,3678,748,0.169001356
C85030,9963,8259,8173,8086,5792,3861,8229,1734,0.174043963
C85033,11752,9597,9478,9374,6721,4069,9940,1812,0.154186521
C85614,3386,2769,2734,2716,1978,1354,2764,622,0.183697578
C85619,7369,5702,5613,5512,3963,2407,6371,998,0.135432216
C85622,2186,1749,1721,1694,1200,855,1821,365,0.166971638
C85623,4163,3318,3277,3241,2548,1609,3463,700,0.16814797
C85628,987,825,813,800,612,380,840,147,0.14893617
C86001,16716,13386,13202,13023,9299,6579,13585,3131,0.187305575
C86002,8144,6476,6387,6284,4510,2957,6822,1322,0.162328094
C86003,9748,7918,7803,7708,5347,4272,7477,2271,0.232970866
C86005,5268,4372,4305,4253,3014,2309,4049,1219,0.231397115
C86006,10177,8431,8342,8243,5885,4036,8393,1784,0.175297239
C86007,13099,10763,10643,10533,7673,5362,10300,2799,0.213680434
C86009,7926,6643,6537,6432,4715,3799,6046,1880,0.237194045
C86011,13319,10997,10863,10723,7801,5295,10772,2547,0.191230573
C86012,5619,4625,4569,4502,3262,2492,4341,1278,0.227442605
C86013,8793,7522,7434,7358,5101,4623,6148,2645,0.30080746
C86015,7984,6513,6413,6326,4470,3344,6302,1682,0.210671343
C86016,8122,6525,6436,6330,4467,3273,6498,1624,0.199950751
C86017,12284,10189,10067,9937,7133,4284,10263,2021,0.164522957
C86018,9955,8195,8094,7976,5613,4106,7891,2064,0.207332998
C86019,14763,11895,11714,11546,8222,5464,12062,2701,0.182957393
C86020,8594,7071,6970,6890,4928,3516,6901,1693,0.196997906
C86021,6062,5027,4958,4909,3473,2669,4662,1400,0.230946882
C86022,10349,8251,8125,8013,5741,3681,8633,1716,0.165813122
C86023,8108,6303,6218,6141,4348,2758,6866,1242,0.153182042
C86024,11595,9444,9308,9191,6463,4673,9344,2251,0.194135403
C86025,7462,6271,6201,6142,4313,2807,6164,1298,0.173948003
C86026,4805,3890,3841,3803,2687,1790,3973,832,0.173152966
C86029,14532,11944,11769,11624,8389,5820,11780,2752,0.189375172
C86032,5818,4787,4725,4653,3392,2471,4669,1149,0.197490547
C86033,4956,3849,3797,3756,2770,1699,4234,722,0.145682002
C86034,7652,6195,6118,6050,4276,2915,6324,1328,0.173549399
C86037,10182,8215,8100,7998,5583,4299,7874,2308,0.226674524
C86038,8992,7365,7270,7165,5041,3621,7336,1656,0.184163701
C86605,7890,6475,6390,6303,4594,3113,6509,1381,0.175031686
C86606,2695,2251,2226,2209,1662,1237,2111,584,0.216697588
C86609,9747,7777,7677,7572,5508,3634,7976,1771,0.181696932
C86611,5313,4378,4313,4249,3130,2396,4166,1147,0.215885564
C86613,4990,4052,3992,3945,2779,1949,4081,909,0.182164329
C86614,9337,7450,7360,7248,5174,3681,7587,1750,0.187426368
C86616,3537,2795,2735,2691,1899,1247,2976,561,0.158608991
C86621,4590,3631,3559,3507,2507,1632,3848,742,0.161655773
C86625,1660,1330,1312,1294,920,576,1400,260,0.156626506
C86626,2297,1867,1841,1807,1315,905,1905,392,0.170657379
C87002,20751,17104,16871,16658,11856,9056,16103,4648,0.223989205
C87003,11100,8911,8777,8631,6032,3937,9299,1801,0.162252252
C87004,11491,9441,9308,9180,6590,4956,8942,2549,0.221825777
C87005,17714,14444,14241,14017,9763,6839,14408,3306,0.186632042
C87006,13893,11193,11051,10901,7681,5357,11321,2572,0.185129202
C87007,11698,9895,9782,9664,6771,5580,8602,3096,0.264660626
C87008,16534,13495,13327,13156,9534,6930,12954,3580,0.216523527
C87009,10223,8262,8139,8023,5676,3805,8377,1846,0.180573217
C87010,4537,3560,3513,3454,2405,1572,3777,760,0.167511572
C87012,14909,11980,11802,11639,8123,5678,12094,2815,0.188812127
C87013,6425,5233,5172,5097,3607,2550,5188,1237,0.192529183
C87014,6936,5537,5463,5391,3942,2445,5856,1080,0.155709343
C87015,6976,5814,5746,5671,4037,3106,5389,1587,0.227494266
C87016,11778,9745,9615,9472,6959,5244,9256,2522,0.214128035
C87017,13119,10555,10393,10232,7252,4983,10751,2368,0.180501563
C87018,8076,6669,6567,6485,4588,3364,6435,1641,0.203194651
C87020,5758,4949,4889,4842,3397,2613,4519,1239,0.215178882
C87022,8032,6361,6284,6215,4376,2941,6601,1431,0.178162351
C87024,3931,3158,3112,3074,2195,1403,3335,596,0.151615365
C87029,11722,9362,9228,9075,6560,4331,9669,2053,0.175140761
C87030,9139,7648,7548,7480,5272,4028,7034,2105,0.230331546
C87031,3442,2826,2786,2753,1924,1444,2702,740,0.214991284
C87603,3530,2936,2900,2856,2054,1302,2987,543,0.153824363
C87604,5601,4606,4555,4504,3358,2289,4520,1081,0.19300125
C87606,1453,1202,1190,1169,835,552,1235,218,0.150034412
C87608,5612,3928,3825,3718,2493,949,5276,336,0.059871703
C87616,5819,4787,4734,4675,3304,2464,4711,1108,0.190410723
C87620,6448,5136,5058,4980,3598,2447,5229,1219,0.189050868
C87622,8371,6481,6400,6283,4422,2132,7561,810,0.096762633
C88005,12202,10269,10192,10092,7308,4584,9944,2258,0.185051631
C88006,4953,3992,3948,3909,2573,1425,4270,683,0.137896225
C88007,29489,27520,27427,27359,8150,2486,28513,976,0.033097087
C88008,14773,10981,10753,10512,7170,3813,13189,1584,0.107222636
C88009,6098,4887,4814,4761,3355,2254,5052,1046,0.17153165
C88010,15127,12864,12701,12563,8937,7235,11187,3940,0.260461427
C88011,4669,3568,3510,3446,2399,1483,3996,673,0.144142215
C88014,8171,6336,6237,6154,4319,2877,6845,1326,0.162281239
C88015,9309,7577,7494,7399,5122,3899,7202,2107,0.226340101
C88016,12596,10382,10241,10099,7189,5412,9724,2872,0.228008892
C88018,8403,7182,7111,7042,5000,3585,6588,1815,0.215994288
C88019,8919,6886,6771,6650,4472,2809,7568,1351,0.151474381
C88020,6726,5163,5059,4983,3579,2010,5875,851,0.126523937
C88021,7158,6132,6055,5993,4249,3385,5428,1730,0.241687622
C88022,4140,3578,3541,3511,2505,2066,2992,1148,0.277294686
C88023,10085,8330,8229,8114,5912,4194,8248,1837,0.18215171
C88024,7069,5955,5848,5773,3988,3392,5333,1736,0.24557929
C88025,8567,7083,6993,6901,4850,3426,6957,1610,0.187930431
C88026,13395,10624,10489,10358,7619,4149,11714,1681,0.125494588
C88027,4693,3386,3301,3232,2171,1156,4164,529,0.112721074
C88028,9863,8123,8008,7908,5603,4040,7695,2168,0.219811416
C88030,7307,6007,5936,5864,4105,2463,6233,1074,0.146982346
C88031,12178,9668,9528,9411,6604,4607,9827,2351,0.193053046
C88032,5618,4729,4667,4610,3202,2632,4184,1434,0.255250979
C88034,9249,7749,7638,7532,5706,4335,7037,2212,0.23916099
C88035,10009,7236,7050,6878,4632,2692,8861,1148,0.114696773
C88036,10376,8331,8234,8139,5700,3848,8528,1848,0.178103315
C88037,12506,10067,9924,9778,6706,4837,9998,2508,0.200543739
C88038,7681,6521,6423,6355,4421,3213,6080,1601,0.208436402
C88039,8618,7057,6960,6873,4787,3599,6712,1906,0.221165003
C88040,5769,4825,4751,4691,3449,2590,4483,1286,0.222915583
C88041,10508,8681,8583,8472,6202,4258,8391,2117,0.20146555
C88043,10756,8629,8508,8381,6267,3537,9252,1504,0.139828933
C88044,4839,3868,3811,3757,2788,1894,3879,960,0.198388097
C88045,9516,7930,7832,7739,5506,3865,7680,1836,0.192938209
C88046,3254,2636,2605,2561,1954,1334,2593,661,0.203134604
C88047,7693,6289,6205,6134,4320,2796,6420,1273,0.165475107
C88048,6877,5183,5085,4993,3468,1793,6093,784,0.114003199
C88049,5321,4418,4365,4310,3006,2193,4311,1010,0.189813945
C88050,3788,3221,3176,3143,2106,1789,2824,964,0.254487856
C88051,7933,5560,5415,5283,3486,1530,7317,616,0.077650321
C88052,9849,8297,8197,8097,5908,3673,8172,1677,0.170271094
C88053,3953,3218,3160,3113,2256,1789,3016,937,0.237035163
C88054,7662,6347,6256,6201,4512,3271,6098,1564,0.20412425
C88059,2893,2474,2440,2410,1805,1007,2498,395,0.136536467
C88060,4000,3115,3068,3011,2062,932,3606,394,0.0985
C88062,4679,3740,3673,3618,2763,1668,4009,670,0.14319299
C88068,3776,3054,3009,2961,2257,1560,2985,791,0.209480932
C88069,17363,12961,12714,12488,8043,3823,15558,1805,0.10395669
C88070,7778,5885,5771,5681,3971,2321,6761,1017,0.130753407
C88072,12208,10250,10116,9986,6809,5422,9527,2681,0.219610092
C88073,5826,4822,4761,4688,3502,2025,5004,822,0.141091658
C88074,5331,4417,4367,4315,3154,2148,4290,1041,0.195272932
C88076,7222,6199,6143,6094,4260,1825,6493,729,0.100941567
C88077,5103,3807,3748,3696,2516,1602,4377,726,0.142269253
C88078,6901,5689,5616,5536,4002,2896,5498,1403,0.203303869
C88079,8429,7019,6938,6863,4872,2387,7447,982,0.116502551
C88082,1190,1062,1050,1044,771,572,919,271,0.227731092
C88083,2678,2285,2253,2225,1634,1327,1996,682,0.254667662
C88084,3084,2399,2356,2319,1588,971,2619,465,0.15077821
C88085,9072,7133,7021,6929,4864,3116,7650,1422,0.156746032
C88086,2913,2250,2216,2191,1485,985,2435,478,0.164092001
C88087,8683,6953,6875,6784,4820,3080,7241,1442,0.166071634
C88088,6029,4566,4489,4434,3070,1805,5262,767,0.127218444
C88090,8670,6884,6765,6663,4682,2665,7569,1101,0.126989619
C88091,2522,1984,1955,1926,1357,880,2116,406,0.160983347
C88092,9576,8114,7996,7889,5524,4490,7198,2378,0.248329156
C88095,5270,4448,4395,4327,3087,2414,4037,1233,0.233965844
C88096,6764,5597,5534,5462,3790,2709,5423,1341,0.19825547
C88622,1932,1631,1612,1592,1012,461,1727,205,0.10610766
C88627,39521,39011,39004,38912,3980,47,39517,4,0.000101212
C88631,1445,1244,1227,1217,907,540,1184,261,0.180622837
C88643,2799,2165,2134,2089,1481,896,2445,354,0.126473741
C88647,4443,3820,3774,3735,2719,2084,3439,1004,0.225973441
C88648,6685,5712,5642,5592,4056,3148,5146,1539,0.230216904
C88652,3701,2900,2868,2833,2082,1081,3193,508,0.1372602
C88655,1172,964,952,933,625,401,1005,167,0.142491468
C88656,3379,2875,2828,2788,1942,1614,2511,868,0.256880734
D81001,12909,11779,11678,11529,6865,3185,11445,1464,0.113409249
D81002,19347,17129,17022,16906,9073,4660,16855,2492,0.1288055
D81003,10062,8497,8422,8347,6149,2733,8848,1214,0.120651958
D81004,10919,8915,8796,8675,6412,4573,8695,2224,0.203681656
D81005,16099,14790,14712,14624,5489,2608,14811,1288,0.080004969
D81008,19860,16757,16569,16371,11381,8255,15547,4313,0.217170191
D81010,12293,10285,10184,10066,7088,4466,10124,2169,0.176441877
D81011,11765,10018,9888,9779,6923,5363,8912,2853,0.242498938
D81012,11622,9477,9350,9240,6561,4078,9547,2075,0.178540699
D81013,19468,16461,16290,16096,8610,2874,18273,1195,0.061382782
D81014,21267,17823,17660,17518,12283,7083,17904,3363,0.158132318
D81015,6947,5818,5739,5661,4159,3336,5242,1705,0.245429682
D81016,12546,10329,10194,10096,6967,3329,11013,1533,0.12219034
D81017,7065,5903,5847,5797,3957,1582,6413,652,0.092285916
D81018,8208,6632,6544,6464,4699,3407,6446,1762,0.214668616
D81021,11654,9431,9314,9186,6675,4323,9547,2107,0.180796293
D81022,84845,68063,67118,66219,47196,28711,71376,13469,0.158748306
D81023,13929,10769,10602,10440,7772,4440,12043,1886,0.135400962
D81025,10863,8911,8821,8703,6282,3418,9311,1552,0.142870294
D81026,27404,22535,22235,21945,15253,10159,22116,5288,0.192964531
D81027,7705,6353,6273,6182,4522,3203,6240,1465,0.190136275
D81028,12372,10078,9919,9779,7068,5143,9714,2658,0.214839961
D81029,12601,10081,9952,9858,7143,4497,10407,2194,0.174113166
D81030,11035,9205,9109,9007,6482,4864,8544,2491,0.225736294
D81031,16810,13540,13354,13165,9740,6070,13921,2889,0.171861987
D81033,4653,3812,3756,3677,2724,2016,3663,990,0.212765957
D81034,15741,13194,12998,12820,9044,7081,11756,3985,0.253160536
D81035,9157,7548,7427,7297,5356,4122,7112,2045,0.223326417
D81036,5894,4858,4784,4718,3472,2463,4660,1234,0.209365456
D81037,10836,10204,10163,10071,4376,1722,10116,720,0.066445183
D81038,6770,5731,5639,5550,4152,3400,5199,1571,0.232053176
D81040,2088,1818,1801,1781,1343,1102,1508,580,0.277777778
D81041,6136,4997,4919,4819,3578,2692,4844,1292,0.210560626
D81042,5659,4569,4528,4491,3357,1924,4723,936,0.165400247
D81043,43482,35807,35305,34821,25483,18673,34003,9479,0.217998252
D81044,14329,11818,11670,11537,7862,4142,12313,2016,0.140693698
D81045,9201,7679,7585,7499,5517,4263,6920,2281,0.247907836
D81046,19524,15509,15301,15081,10962,7067,16012,3512,0.179881172
D81047,7816,6384,6287,6180,4638,3679,6055,1761,0.225307062
D81049,10349,8444,8331,8235,5960,4251,8032,2317,0.223886366
D81050,14339,11732,11590,11461,8437,5456,11798,2541,0.17720901
D81051,8625,7041,6935,6825,5051,3722,6831,1794,0.208
D81052,8953,7472,7369,7285,5021,4129,6703,2250,0.251312409
D81054,21956,19917,19700,19384,10395,4022,20322,1634,0.07442157
D81055,5842,4829,4758,4699,3344,2739,4290,1552,0.265662444
D81056,8385,7392,7344,7297,5077,1795,7775,610,0.072748956
D81057,24105,19786,19532,19291,14023,9911,18976,5129,0.212777432
D81058,7070,5773,5692,5600,4160,3198,5469,1601,0.226449788
D81059,7038,5883,5814,5745,4069,3178,5359,1679,0.238562092
D81060,6675,5615,5551,5484,4059,3201,5110,1565,0.234456929
D81061,12190,10048,9911,9805,6963,5060,9699,2491,0.204347826
D81062,7320,5976,5884,5806,4360,3244,5740,1580,0.215846995
D81064,6173,5198,5151,5095,3558,3070,4438,1735,0.281062692
D81065,5540,4040,3956,3880,2716,1274,5070,470,0.084837545
D81066,8560,7027,6937,6851,4781,2826,7189,1371,0.160163551
D81070,11344,9965,9768,9456,5168,1726,10701,643,0.056681946
D81073,5382,4127,4067,3987,2864,1481,4784,598,0.111111111
D81078,3665,3021,2994,2967,2265,1348,3050,615,0.167803547
D81081,3561,3050,3015,2982,2248,1782,2662,899,0.252457175
D81082,7031,5814,5722,5650,4082,2879,5799,1232,0.175224008
D81084,9449,7321,7205,7108,5412,2964,8116,1333,0.141073129
D81085,7350,5851,5764,5678,4374,2681,6171,1179,0.160408163
D81086,7385,6019,5945,5883,4194,2136,6432,953,0.129045362
D81602,3847,3035,2971,2929,2106,1329,3192,655,0.170262542
D81603,8232,6751,6659,6568,4550,3402,6500,1732,0.210398445
D81606,12359,10178,10027,9891,7390,4891,10159,2200,0.178007929
D81607,3067,2477,2440,2401,1807,1169,2524,543,0.177045973
D81611,12357,10155,10006,9883,7254,5422,9676,2681,0.216962046
D81612,5173,4299,4239,4190,3112,1949,4282,891,0.172240479
D81615,7949,6203,6140,6071,4520,2342,6886,1063,0.133727513
D81618,4651,3599,3544,3498,2630,1551,3972,679,0.14599011
D81622,12041,9544,9421,9290,6556,3396,10622,1419,0.117847355
D81623,3997,3435,3402,3361,2471,1785,2996,1001,0.250437828
D81625,27512,21068,20734,20464,14402,5173,26077,1435,0.052159058
D81629,5056,3982,3912,3849,2794,1619,4325,731,0.144580696
D81630,10183,7327,7181,7025,5205,1874,9568,615,0.060394776
D81631,13001,9624,9426,9244,6468,2068,12350,651,0.050073071
D81633,10266,7776,7630,7514,5439,2390,9394,872,0.084940581
D81637,12191,8465,8258,8078,6419,2070,11618,573,0.047001887
D81645,2910,2228,2188,2152,1532,717,2585,325,0.111683849
D82001,13897,12110,11993,11880,8065,8131,8841,5056,0.363819529
D82002,13307,10924,10767,10633,7516,4829,11093,2214,0.166378598
D82003,25263,20824,20517,20239,13913,10705,19609,5654,0.223805565
D82004,12814,11205,11079,10982,7645,7402,8313,4501,0.351256438
D82005,9345,8258,8187,8084,5300,5725,5594,3751,0.401391118
D82006,8749,7373,7240,7139,5009,4297,6409,2340,0.267459138
D82007,25194,20779,20515,20234,14188,9674,20502,4692,0.186234818
D82008,18852,16312,16134,15994,11415,7688,14811,4041,0.214353915
D82009,7562,6549,6486,6428,4586,4172,5230,2332,0.308384025
D82010,5071,4349,4298,4262,3099,2715,3602,1469,0.289686452
D82011,16626,13731,13550,13383,9377,6502,13172,3454,0.207746902
D82012,13739,11472,11366,11240,8038,5222,11010,2729,0.198631633
D82013,7279,5935,5856,5780,4256,2787,5891,1388,0.190685534
D82015,8676,7493,7420,7345,4919,4604,5906,2770,0.319271554
D82016,9801,8253,8138,8033,5753,4859,7108,2693,0.274767881
D82017,10768,8672,8565,8432,6167,3528,9022,1746,0.162147103
D82018,10527,8912,8819,8708,6011,4974,7817,2710,0.257433267
D82019,18864,15880,15694,15507,11024,8846,14018,4846,0.256891433
D82020,11042,8952,8841,8708,6026,4544,8630,2412,0.218438689
D82022,7118,6019,5945,5891,4126,3288,5269,1849,0.259763979
D82023,13769,10867,10737,10628,7679,4464,11563,2206,0.160214976
D82024,8373,7019,6913,6801,4848,3591,6627,1746,0.20852741
D82025,9010,7849,7768,7694,5328,5000,5959,3051,0.338623751
D82026,8422,7093,7016,6947,5133,3369,6619,1803,0.214082166
D82027,7768,6879,6813,6761,4582,4864,4603,3165,0.407440783
D82028,5822,5114,5065,5015,3452,3393,3777,2045,0.351253865
D82029,18241,15158,14977,14795,10617,8308,13918,4323,0.236993586
D82030,8976,7577,7469,7364,5389,4571,6477,2499,0.278409091
D82031,7964,6797,6713,6640,4591,3809,5789,2175,0.273103968
D82032,7976,6786,6704,6634,4752,4052,5746,2230,0.279588766
D82034,18248,15163,14928,14674,10165,7966,14006,4242,0.232463832
D82035,10466,8743,8625,8532,6149,5041,7863,2603,0.248710109
D82036,8457,7076,6990,6902,4962,4075,6309,2148,0.253990777
D82037,11221,9292,9175,9068,6614,5138,8590,2631,0.234471081
D82038,3193,2750,2726,2705,1825,1720,2180,1013,0.317256499
D82039,8662,7410,7326,7247,5159,4497,6141,2521,0.29104133
D82040,12690,9636,9486,9320,6526,3505,11183,1507,0.118754925
D82041,11827,9561,9430,9292,6691,4282,9763,2064,0.174515938
D82042,8429,7032,6948,6889,5073,4085,6307,2122,0.251749911
D82043,6712,5626,5562,5473,3912,3188,5066,1646,0.24523242
D82044,32151,26892,26596,26251,17805,14724,23503,8648,0.268980747
D82045,18931,15422,15106,14780,10437,8208,14615,4316,0.227985843
D82046,4530,3818,3772,3726,2697,2344,3238,1292,0.285209713
D82047,7920,7130,7063,7016,4652,3162,6368,1552,0.195959596
D82048,13822,11400,11240,11094,7916,5759,10930,2892,0.20923166
D82049,3601,3025,2995,2961,2141,1875,2591,1010,0.280477645
D82050,8856,7485,7391,7285,4976,4118,6558,2298,0.259485095
D82051,16797,14039,13870,13721,9569,6816,13271,3526,0.209918438
D82053,5754,5050,5014,4967,3410,3482,3633,2121,0.368613139
D82054,15062,12846,12715,12586,8668,7687,10606,4456,0.295843845
D82056,9866,8256,8146,8047,5743,5024,7038,2828,0.286640989
D82057,7419,6381,6319,6265,4186,3945,5016,2403,0.323898099
D82058,17444,15198,15034,14849,10537,9645,11923,5521,0.31649851
D82059,11638,9889,9759,9654,6624,5898,8304,3334,0.286475339
D82060,4577,3577,3516,3468,2396,1688,3676,901,0.196853834
D82062,8837,7402,7321,7259,5250,4205,6568,2269,0.256761344
D82063,13063,10974,10872,10772,7290,5961,9650,3413,0.261272296
D82064,20584,16687,16486,16295,11851,8712,15797,4787,0.232559269
D82065,7160,6090,6029,5977,4172,3794,4924,2236,0.312290503
D82066,6597,5708,5643,5562,3823,3497,4595,2002,0.303471275
D82067,13448,10981,10836,10709,7449,4847,11082,2366,0.175936942
D82068,7229,6207,6140,6074,4185,3833,5005,2224,0.307649744
D82070,6417,5432,5379,5327,3900,3299,4645,1772,0.276141499
D82071,16296,13616,13456,13266,9291,7407,12359,3937,0.241593029
D82072,4237,3698,3655,3626,2514,2535,2611,1626,0.383762096
D82073,9792,7949,7836,7752,5629,3376,8157,1635,0.166973039
D82076,7432,6212,6146,6090,4366,2899,5973,1459,0.19631324
D82078,9708,8128,8012,7920,5691,4572,7339,2369,0.244025546
D82079,5200,4317,4263,4209,3121,2493,3941,1259,0.242115385
D82080,7182,5890,5814,5746,4172,3298,5356,1826,0.254246728
D82084,7884,6722,6648,6573,4641,4142,5447,2437,0.309107052
D82085,6461,5463,5399,5336,3913,3283,4714,1747,0.27039158
D82087,6892,5477,5405,5332,3817,1833,6177,715,0.103743471
D82088,21801,21116,21084,21024,3545,583,21696,105,0.004816293
D82096,8030,6260,6179,6065,4289,2256,7000,1030,0.128268991
D82099,17078,13829,13653,13479,9754,5147,15057,2021,0.118339384
D82100,4160,3539,3500,3464,2483,2165,3015,1145,0.275240385
D82104,9351,7943,7844,7737,5561,4801,6709,2642,0.282536627
D82105,6366,5223,5138,5082,3567,2820,4877,1489,0.233898838
D82106,4422,3724,3687,3647,2608,1544,3687,735,0.166214383
D82600,2028,1763,1744,1729,1273,1157,1373,655,0.322978304
D82604,3040,2634,2609,2572,1815,1670,2136,904,0.297368421
D82618,5793,4759,4700,4626,3301,2505,4471,1322,0.228206456
D82621,5980,5122,5073,5017,3570,3243,4072,1908,0.319063545
D82624,6050,4818,4741,4681,3487,2233,5046,1004,0.165950413
D82628,3552,3080,3046,3022,2230,2009,2453,1099,0.309403153
D83001,10260,8763,8624,8507,6022,5306,7315,2945,0.287037037
D83002,15380,12514,12328,12148,8503,6038,12228,3152,0.204941482
D83003,5005,4318,4278,4241,3078,2747,3522,1483,0.296303696
D83004,10993,9111,8982,8886,6336,4728,8589,2404,0.218684617
D83005,13737,11826,11682,11549,7905,6533,9970,3767,0.274222902
D83006,6838,5876,5795,5741,4107,3722,4835,2003,0.292921907
D83007,9003,7433,7317,7216,5139,4327,6739,2264,0.251471732
D83008,16733,13550,13388,13234,9641,5384,14199,2534,0.15143728
D83009,19846,16857,16631,16440,11429,9862,14211,5635,0.28393631
D83010,6475,5647,5583,5531,3894,3683,4304,2171,0.335289575
D83011,12096,10333,10208,10075,7021,6092,8558,3538,0.292493386
D83012,18480,14919,14687,14507,10522,7011,15216,3264,0.176623377
D83013,12272,10558,10444,10332,7129,5790,9010,3262,0.265808344
D83014,9168,8025,7924,7847,5602,5337,5923,3245,0.353948517
D83015,8317,7303,7237,7179,4867,4662,5437,2880,0.346278706
D83016,10978,9219,9098,8984,6277,5098,8121,2857,0.260247768
D83017,12485,10589,10461,10331,7352,5931,9337,3148,0.252142571
D83018,12200,10074,9956,9837,7021,5142,9476,2724,0.223278689
D83019,7622,6486,6413,6343,4659,3869,5651,1971,0.258593545
D83020,7890,6575,6426,6297,4459,3926,5840,2050,0.25982256
D83021,15898,12763,12589,12418,8945,5694,13123,2775,0.174550258
D83022,5206,4565,4510,4460,2939,3043,3357,1849,0.355167115
D83023,12771,10503,10355,10222,7007,5264,9899,2872,0.224884504
D83024,12209,10223,10071,9919,7146,4978,9844,2365,0.193709559
D83026,9764,8236,8070,7911,5503,4953,7074,2690,0.275501844
D83027,11116,9215,9117,9021,6567,4258,9084,2032,0.182799568
D83028,7467,6313,6237,6172,4285,3734,5311,2156,0.28873711
D83029,14126,12037,11901,11772,8466,5635,11211,2915,0.206357072
D83030,6309,5183,5113,5056,3610,2369,5198,1111,0.176097638
D83033,9193,7874,7767,7675,5585,4910,6518,2675,0.290982269
D83034,11248,9587,9475,9369,6561,5665,8050,3198,0.284317212
D83035,10410,9008,8903,8818,6147,5862,6938,3472,0.333525456
D83037,15377,12707,12526,12371,8717,7373,11281,4096,0.266371854
D83038,14248,11663,11490,11325,8233,5888,11298,2950,0.207046603
D83039,12702,9938,9785,9649,6900,4262,10676,2026,0.159502441
D83040,10933,9003,8834,8646,6058,4779,8304,2629,0.240464648
D83041,8857,7410,7282,7177,5340,4432,6638,2219,0.250536299
D83043,5992,5122,5051,4989,3566,3198,4160,1832,0.305740988
D83044,20415,16631,16428,16221,11423,7870,16387,4028,0.197305903
D83045,5221,4412,4359,4315,3062,2417,3908,1313,0.25148439
D83046,26378,21536,21195,20895,15023,10150,21289,5089,0.192925923
D83047,14936,12387,12238,12092,8519,6713,11280,3656,0.244777718
D83048,14733,12608,12496,12365,8771,7605,10470,4263,0.289350438
D83049,6891,5964,5904,5825,3994,3796,4683,2208,0.320417936
D83050,7340,6064,5981,5898,4150,2992,5885,1455,0.198228883
D83051,17643,14033,13816,13609,9854,6317,14668,2975,0.168622116
D83053,9439,7898,7782,7685,5461,4864,6695,2744,0.290708762
D83054,7678,6745,6675,6618,4608,4529,4986,2692,0.350612139
D83055,14093,11871,11725,11581,8305,7012,10301,3792,0.269069751
D83056,9226,7136,7014,6878,4763,2841,7850,1376,0.149143724
D83057,13280,10787,10618,10472,7432,6066,9888,3392,0.255421687
D83058,9956,8237,8128,8010,5532,3642,8028,1928,0.193652069
D83059,19435,15192,14974,14751,10530,5368,17063,2372,0.122047852
D83060,23748,19861,19587,19332,13619,10866,17896,5852,0.246420751
D83061,9888,8248,8144,8025,5821,4713,7370,2518,0.254652104
D83062,7647,6425,6367,6296,4467,3564,5691,1956,0.255786583
D83064,5266,4395,4338,4278,3039,2539,3845,1421,0.269844284
D83067,7135,5807,5733,5659,4322,2657,5956,1179,0.165241766
D83069,5816,4910,4848,4791,3434,3124,4079,1737,0.298658872
D83070,5356,4481,4418,4363,3093,2663,3864,1492,0.278566094
D83073,6264,5105,5052,5008,3537,1759,5424,840,0.134099617
D83074,14460,11744,11603,11465,8343,4105,12699,1761,0.121784232
D83075,10189,8414,8318,8223,5849,4187,8118,2071,0.203258416
D83076,5432,4610,4560,4508,3282,2975,3745,1687,0.31056701
D83078,9188,7074,6993,6917,5184,2890,7985,1203,0.13093165
D83079,9276,7722,7612,7507,5374,4037,7297,1979,0.21334627
D83080,6198,5167,5107,5032,3659,2823,4649,1549,0.249919329
D83081,8158,6749,6651,6559,4748,3483,6522,1636,0.200539348
D83082,2460,2029,1993,1967,1406,885,2087,373,0.151626016
D83084,7424,5997,5895,5792,4067,3020,5831,1593,0.214574353
D83608,6758,5573,5497,5424,3844,3180,4978,1780,0.263391536
D83610,12399,10181,10001,9858,7142,4632,10369,2030,0.163722881
D83615,3268,2656,2616,2589,1889,1246,2624,644,0.197062424
E81001,3278,2582,2542,2510,1926,932,2955,323,0.098535692
E81002,9441,7419,7321,7210,5465,3375,8003,1438,0.152314373
E81003,17316,13924,13757,13588,10009,6747,13794,3522,0.203395703
E81004,11531,9254,9122,9008,6598,4400,9373,2158,0.187147689
E81005,10386,7978,7854,7730,5573,3143,8979,1407,0.135470826
E81006,9734,7923,7811,7694,5404,3766,7916,1818,0.18676803
E81007,6205,5204,5132,5052,3761,2934,4791,1414,0.227880741
E81008,13386,10512,10320,10137,7338,4413,11492,1894,0.14149111
E81009,11984,9923,9795,9682,6922,5041,9518,2466,0.205774366
E81010,8313,6385,6284,6193,4272,2611,7040,1273,0.153133646
E81012,12055,9985,9875,9766,7267,5556,9236,2819,0.233844878
E81013,17063,14291,14159,14019,9823,4985,15088,1975,0.115747524
E81014,14821,11598,11465,11336,8256,4467,12821,2000,0.134943661
E81015,14633,12148,11983,11809,8765,6182,11851,2782,0.190118226
E81016,6450,4829,4728,4618,3264,1741,5748,702,0.108837209
E81018,11916,9324,9152,8950,6185,3942,10088,1828,0.153407184
E81019,19173,14707,14428,14212,10218,5231,17010,2163,0.112814896
E81021,11623,8763,8611,8475,6027,2921,10461,1162,0.099974189
E81022,13526,10642,10503,10388,8087,5035,11265,2261,0.167159545
E81023,3159,2623,2597,2564,1804,1178,2618,541,0.171256727
E81024,5773,4869,4788,4717,3370,2903,4262,1511,0.261735666
E81025,6373,4970,4904,4839,3389,2060,5374,999,0.15675506
E81026,8478,6741,6642,6542,4870,2707,7446,1032,0.121726822
E81027,11882,9220,9065,8915,6696,3621,10482,1400,0.117825282
E81028,14730,10376,10115,9869,7037,3002,13574,1156,0.078479294
E81029,16074,12900,12713,12499,8870,5681,13314,2760,0.17170586
E81030,9240,7234,7122,7030,5050,1814,8677,563,0.060930736
E81031,5016,4205,4157,4123,3040,2364,3852,1164,0.232057416
E81032,26180,20040,19726,19423,13680,5960,23957,2223,0.084912147
E81033,18050,14464,14246,14052,10287,7277,14591,3459,0.191634349
E81034,7614,6301,6199,6115,4472,3288,6149,1465,0.192408721
E81035,8730,6999,6872,6757,4983,3391,7080,1650,0.189003436
E81036,13722,11020,10901,10787,7934,4955,11246,2476,0.180440169
E81037,38323,32235,31796,31358,22407,16352,30329,7994,0.20859536
E81038,12395,10185,10060,9938,7137,5166,9752,2643,0.213231142
E81040,9127,7449,7357,7251,5168,3691,7385,1742,0.190862277
E81041,13470,10127,9956,9768,6974,3792,11906,1564,0.116109874
E81043,10937,8951,8859,8764,5403,3112,9531,1406,0.128554448
E81044,20218,16143,15943,15768,12066,7040,17097,3121,0.154367395
E81045,9124,7371,7276,7187,5099,3523,7185,1939,0.21251644
E81046,11799,9827,9684,9549,6806,5423,9046,2753,0.233324858
E81047,10720,8782,8676,8567,6037,3791,8893,1827,0.170429104
E81048,8464,6642,6523,6401,4504,2421,7472,992,0.117202268
E81049,7437,6122,6030,5945,4390,3157,5904,1533,0.206131505
E81050,11852,9838,9715,9622,7158,5271,9289,2563,0.216250422
E81052,9277,7566,7458,7364,5249,3725,7608,1669,0.179907298
E81056,5940,4747,4663,4598,3428,2006,5019,921,0.155050505
E81057,20509,16633,16400,16162,11737,7957,16834,3675,0.179189624
E81060,6057,4961,4911,4858,3344,2184,4939,1118,0.184579825
E81061,5971,4736,4676,4599,3513,2393,4919,1052,0.176184894
E81063,8183,5888,5717,5553,3694,1436,7636,547,0.0668459
E81064,5988,4690,4615,4535,3340,1880,5234,754,0.125918504
E81065,4779,3540,3465,3398,2535,909,4385,394,0.082444026
E81069,5151,4332,4273,4226,3057,2468,3775,1376,0.267132596
E81073,15375,11933,11778,11647,8638,3936,13860,1515,0.098536585
E81074,11198,9187,9055,8915,6439,4782,8891,2307,0.206018932
E81076,3863,2827,2771,2699,1983,1058,3438,425,0.110018121
E81077,6155,4693,4636,4588,3471,1911,5328,827,0.134362307
E81611,3210,2646,2610,2578,1954,1350,2589,621,0.193457944
E81612,5772,4328,4226,4142,2959,1468,5193,579,0.10031185
E81615,4017,3124,3065,3008,2126,799,3746,271,0.067463281
E81617,5003,4039,3976,3917,2970,2006,4104,899,0.179692185
E81631,4269,3098,3023,2963,2035,642,4031,238,0.055750761
E81632,7888,6513,6420,6350,4534,3210,6368,1520,0.192697769
E81633,3656,2657,2601,2555,1845,833,3350,306,0.083698031
E81635,2795,2340,2306,2275,1560,1138,2260,535,0.191413238
E82001,24469,19702,19363,19047,14191,9907,19809,4660,0.190445053
E82002,9555,7644,7533,7425,5321,3153,8082,1473,0.154160126
E82004,4692,3782,3733,3686,2720,1022,4259,433,0.09228474
E82005,35989,28550,28136,27736,20099,11732,31203,4786,0.132985079
E82006,8270,6983,6873,6788,4810,3695,6322,1948,0.235550181
E82007,11590,9277,9150,9036,6805,4361,9619,1971,0.170060397
E82008,10548,8473,8372,8273,5889,3993,8505,2043,0.193686007
E82009,13649,11163,11038,10929,8014,4629,11481,2168,0.158839475
E82012,14559,11475,11286,11132,8247,4692,12551,2008,0.137921561
E82013,30561,23971,23585,23208,17217,9053,26724,3837,0.125552174
E82014,20822,16177,15888,15628,11746,7269,17551,3271,0.157093459
E82015,10332,8599,8492,8406,6256,3590,8643,1689,0.163472706
E82017,11832,9256,9121,8977,6648,3595,10280,1552,0.131169709
E82018,13269,10537,10410,10281,7408,4250,11240,2029,0.152912804
E82019,15937,13305,13074,12886,9291,7540,12165,3772,0.236681935
E82020,6566,5389,5302,5234,3783,2399,5514,1052,0.160219312
E82021,6687,5523,5447,5365,3925,3027,5257,1430,0.213847764
E82022,17133,13723,13557,13408,9726,5658,14583,2550,0.14883558
E82023,11689,9307,9197,9088,6491,3090,10395,1294,0.11070237
E82024,14911,12250,12079,11915,8693,5877,12315,2596,0.174099658
E82027,12547,10546,10412,10270,6865,5292,9727,2820,0.224754921
E82028,13110,10614,10452,10264,7748,5730,10379,2731,0.208314264
E82031,18671,15053,14848,14659,11226,5795,16529,2142,0.114723368
E82032,17585,13974,13745,13562,9939,5992,14948,2637,0.14995735
E82034,6546,5321,5222,5144,3723,2466,5371,1175,0.179498931
E82035,12654,10384,10239,10134,7202,5122,10091,2563,0.20254465
E82037,15769,12377,12144,11934,8795,6484,12445,3324,0.210793329
E82038,8958,7293,7180,7072,5211,3984,7102,1856,0.207189105
E82040,20847,16822,16581,16355,11839,7475,17556,3291,0.157864441
E82041,10525,8282,8151,8013,5855,3634,8909,1616,0.153539192
E82042,9580,7673,7576,7463,5337,3111,8263,1317,0.137473904
E82043,13345,10839,10682,10540,7672,5336,10566,2779,0.208242788
E82044,14077,11570,11398,11234,8286,5780,11324,2753,0.195567237
E82045,9553,7786,7708,7599,5463,2128,8838,715,0.074845598
E82046,11547,9462,9327,9209,6628,4799,9289,2258,0.195548627
E82048,9324,7610,7513,7422,5525,3297,7827,1497,0.160553411
E82049,3781,3147,3112,3070,2157,1716,2896,885,0.234065062
E82050,4927,3855,3806,3759,2869,1563,4226,701,0.142277248
E82051,14143,11286,11144,11030,7984,5076,11748,2395,0.169341724
E82053,17985,14410,14237,14071,10466,6226,15005,2980,0.165693634
E82055,13100,10431,10262,10109,7296,5389,10287,2813,0.214732824
E82056,8469,6761,6669,6584,4781,3073,7130,1339,0.158106034
E82057,32,29,29,29,23,12,29,3,0.09375
E82058,17651,16284,16184,16058,5481,3645,15930,1721,0.097501558
E82059,10618,8409,8268,8131,6111,3760,8820,1798,0.169335091
E82060,21278,16707,16444,16203,12498,6704,18385,2893,0.135962027
E82061,13167,10798,10651,10505,7448,4991,10703,2464,0.187134503
E82062,16202,13299,13118,12958,9271,6467,13091,3111,0.192013332
E82063,12505,9561,9418,9286,6791,3946,10756,1749,0.139864054
E82064,6954,5583,5471,5372,3912,2825,5644,1310,0.188380788
E82066,3356,2770,2741,2692,1980,1324,2778,578,0.172228844
E82067,16258,13194,12962,12762,9365,6071,13621,2637,0.162197072
E82068,11814,9645,9487,9334,6921,4710,9612,2202,0.18638903
E82069,6843,5479,5433,5369,3830,1417,6233,610,0.089142189
E82070,3084,2394,2354,2323,1789,806,2805,279,0.090466926
E82071,16512,12710,12466,12276,9249,5912,13979,2533,0.153403585
E82072,11729,9520,9388,9284,6897,4507,9355,2374,0.202404297
E82073,25821,20463,20153,19874,14822,8301,22168,3653,0.141473994
E82074,21243,17619,17329,17001,11795,7424,17968,3275,0.154168432
E82075,12760,10288,10147,10014,7267,4823,10412,2348,0.184012539
E82077,11984,9455,9304,9151,6751,4760,9830,2154,0.179739653
E82078,9466,7789,7644,7524,5218,3656,7732,1734,0.183181914
E82079,8646,6682,6577,6461,4704,2693,7497,1149,0.132893824
E82081,13097,10817,10664,10506,7458,5821,10314,2783,0.21249141
E82082,12977,10633,10460,10316,7265,5502,10183,2794,0.215303999
E82083,10557,8611,8479,8350,6045,4172,8550,2007,0.190110827
E82084,14102,11133,10956,10783,8150,4869,11989,2113,0.149836903
E82085,19990,16181,15922,15667,11341,7864,16264,3726,0.186393197
E82086,15718,12829,12656,12495,9235,5201,13283,2435,0.154917928
E82088,9093,7387,7282,7172,5162,3624,7280,1813,0.199384142
E82089,14965,12052,11860,11689,8396,5358,12657,2308,0.154226529
E82090,10785,9047,8923,8798,6177,4884,8279,2506,0.232359759
E82091,17393,14146,13942,13754,9978,6729,14287,3106,0.178577589
E82092,14511,11817,11663,11530,8452,5519,11920,2591,0.1785542
E82093,12845,10231,10076,9929,7141,4495,10893,1952,0.151965745
E82094,11362,9177,9059,8944,6638,4504,9178,2184,0.19221968
E82096,10923,8728,8615,8491,6213,3909,9244,1679,0.15371235
E82098,8244,6773,6675,6574,4608,3453,6534,1710,0.207423581
E82099,12905,10660,10512,10369,7471,5334,10440,2465,0.191011236
E82100,12539,10267,10136,10004,7359,5151,9951,2588,0.206396044
E82102,9681,7950,7849,7756,5714,3774,7837,1844,0.19047619
E82104,5061,4183,4120,4061,2944,2266,3822,1239,0.244813278
E82105,4795,3807,3751,3679,2772,1516,4197,598,0.124713243
E82106,10841,8679,8561,8442,6199,4212,8765,2076,0.19149525
E82107,8834,7019,6911,6809,5001,3000,7451,1383,0.156554222
E82109,10291,8150,8036,7927,5951,3451,8673,1618,0.157224759
E82111,4483,3583,3543,3497,2539,1541,3778,705,0.157260763
E82113,4137,3418,3378,3331,2459,1614,3375,762,0.184191443
E82115,10927,9092,8971,8854,6322,4502,8863,2064,0.188889906
E82117,13516,10411,10267,10148,7481,3763,11921,1595,0.118008286
E82121,5169,4249,4179,4107,3065,2170,4137,1032,0.19965177
E82123,10306,8480,8379,8272,5712,4153,8178,2128,0.206481661
E82124,24405,19534,19253,18973,13765,7759,20912,3493,0.143126409
E82126,92,77,76,74,53,37,78,14,0.152173913
E82129,14924,12240,12078,11903,8725,6022,12146,2778,0.186143125
E82130,10215,8195,8079,7969,5836,4274,8156,2059,0.201566324
E82131,2690,2283,2253,2229,1657,1221,2142,548,0.203717472
E82132,6600,5330,5269,5192,3733,2396,5481,1119,0.169545455
E82133,5590,4528,4462,4406,3182,2051,4606,984,0.176028623
E82603,8959,7317,7215,7120,5157,2416,7971,988,0.110280165
E82620,974,680,567,419,124,60,955,19,0.019507187
E82626,2805,2252,2215,2181,1630,1188,2266,539,0.192156863
E82638,6519,5084,5019,4937,3632,1805,5848,671,0.102929897
E82640,6505,5010,4937,4865,3533,1731,5822,683,0.104996157
E82641,6152,4819,4755,4702,3632,1908,5512,640,0.104031209
E82643,2499,2050,2019,1993,1461,1059,1990,509,0.203681473
E82644,2751,2004,1982,1955,1443,581,2567,184,0.066884769
E82652,2621,2082,2060,2036,1557,1006,2095,526,0.200686761
E82654,6591,5005,4929,4854,3738,1806,5795,796,0.120770748
E82655,3456,2803,2760,2714,1910,1134,2982,474,0.137152778
E82657,6276,5105,5026,4947,3377,2585,4882,1394,0.222115997
E82661,7965,6318,6231,6140,4454,2491,6833,1132,0.142121783
E83003,9141,7307,7200,7107,5258,3328,7616,1525,0.166830762
E83005,6348,5147,5097,5035,3771,1570,5703,645,0.101606805
E83006,6804,5531,5451,5382,3848,2007,5992,812,0.119341564
E83007,5856,4802,4734,4667,3390,1891,5019,837,0.142930328
E83008,8666,6724,6624,6522,4700,2826,7263,1403,0.161897069
E83009,11211,8791,8655,8513,6101,3686,9289,1922,0.171438765
E83010,11384,9378,9283,9177,6826,3763,9587,1797,0.157853127
E83011,8779,6699,6603,6481,4594,2031,8038,741,0.084405969
E83012,8483,6987,6912,6822,4998,3273,6853,1630,0.192149004
E83013,6060,5054,5009,4955,3690,2109,5026,1034,0.170627063
E83016,18640,14789,14518,14256,10236,6041,15782,2858,0.15332618
E83017,11439,9540,9402,9262,6725,4759,9270,2169,0.189614477
E83018,16506,13343,13167,13021,9593,5170,14189,2317,0.140373198
E83020,11833,9460,9359,9251,6441,3018,10402,1431,0.120932984
E83021,12323,10135,10003,9882,7126,4447,10114,2209,0.179258297
E83024,11158,9056,8917,8782,6377,4142,9114,2044,0.183186951
E83025,8950,7109,6984,6863,4840,2661,7744,1206,0.134748603
E83026,4386,3702,3655,3610,2679,1634,3564,822,0.187414501
E83027,8312,7108,7026,6962,4705,2449,7069,1243,0.14954283
E83028,6640,5015,4924,4837,3508,1667,6052,588,0.088554217
E83030,6752,5415,5335,5240,3578,2501,5435,1317,0.195053318
E83031,5275,4228,4174,4118,3034,1899,4371,904,0.171374408
E83032,18097,14104,13883,13655,9805,4398,16470,1627,0.089904404
E83034,5356,4394,4335,4268,3189,1884,4548,808,0.15085885
E83035,11900,9512,9359,9221,6895,3718,10225,1675,0.140756303
E83036,5857,4447,4355,4268,3093,1646,5135,722,0.123271299
E83037,5620,4583,4525,4462,3217,1893,4696,924,0.164412811
E83038,8470,7051,6972,6894,4824,2760,7143,1327,0.156670602
E83039,6130,5360,5325,5281,2852,1232,5545,585,0.0954323
E83041,4512,3772,3738,3701,2702,1242,4021,491,0.108820922
E83044,9434,7619,7515,7423,5471,3405,7830,1604,0.17002332
E83045,9502,7562,7422,7318,5458,2883,8265,1237,0.130183119
E83046,9680,7814,7701,7589,5480,2816,8570,1110,0.114669421
E83049,8399,6438,6352,6248,4696,2178,7450,949,0.112989642
E83050,8009,6642,6557,6474,4724,2528,6944,1065,0.132975403
E83053,13327,10330,10195,10056,7127,4187,11126,2201,0.165153448
E83600,6261,3886,3782,3701,2218,1125,5692,569,0.090880051
E83613,11614,9302,9162,9015,6549,4175,9716,1898,0.163423454
E83621,8534,7078,6956,6858,4922,3336,6970,1564,0.183266932
E83622,7630,5856,5761,5674,3974,2207,6462,1168,0.153079948
E83637,9682,7784,7701,7630,5305,1742,9016,666,0.068787441
E83638,5105,4205,4150,4086,3042,1951,4192,913,0.17884427
E83639,5987,4884,4845,4804,3567,1272,5479,508,0.084850509
E83649,3977,3326,3300,3258,2381,1114,3478,499,0.125471461
E83650,1895,1626,1610,1595,1138,889,1420,475,0.250659631
E83653,10310,7999,7900,7777,5444,2761,9037,1273,0.123472357
E83657,1865,1608,1589,1571,1144,683,1561,304,0.163002681
E83668,4259,3497,3443,3392,2566,1261,3833,426,0.10002348
E84002,6658,5479,5413,5326,3867,2379,5639,1019,0.153048964
E84003,8687,7221,7162,7086,4713,1989,7881,806,0.092782318
E84004,8729,7127,7001,6891,4890,3165,7269,1460,0.167258563
E84005,7300,6023,5916,5838,4042,2708,6028,1272,0.174246575
E84006,18001,14906,14699,14500,10631,6039,15567,2434,0.13521471
E84007,5511,4583,4534,4479,3127,2197,4260,1251,0.227000544
E84008,10818,8908,8805,8694,6219,4025,8899,1919,0.177389536
E84009,12529,10195,10048,9900,6871,4502,10325,2204,0.175911884
E84011,1932,1704,1690,1671,1320,797,1569,363,0.187888199
E84012,9191,7861,7787,7734,5745,2818,8081,1110,0.120770319
E84013,8025,6207,6087,5964,4129,2272,7158,867,0.108037383
E84014,8520,7049,6964,6874,4865,3092,6921,1599,0.187676056
E84015,16074,13078,12877,12684,9113,4980,14040,2034,0.126539754
E84017,8907,7433,7324,7215,5189,2925,7601,1306,0.146626249
E84018,7883,6559,6473,6393,4585,2941,6365,1518,0.192566282
E84020,6337,5347,5289,5236,3717,2102,5352,985,0.155436326
E84021,13489,11202,11083,10959,7838,3450,12242,1247,0.092445696
E84022,7409,6037,5945,5845,4155,2336,6442,967,0.130516939
E84024,20171,16235,16015,15797,11627,7703,16183,3988,0.197709583
E84025,23163,18830,18587,18356,14171,6383,20935,2228,0.096187886
E84028,7207,5930,5826,5745,4026,2324,6405,802,0.111280699
E84030,7268,5804,5692,5590,3854,2153,6423,845,0.116263071
E84031,9025,7145,7013,6859,4733,2724,8052,973,0.107811634
E84032,9009,7152,7044,6934,4834,2188,8160,849,0.094239094
E84033,7219,5443,5354,5261,3609,1362,6693,526,0.072863277
E84036,9317,7279,7171,7075,5130,2304,8511,806,0.086508533
E84039,13479,10856,10707,10570,7502,4133,11619,1860,0.137992433
E84040,4340,3618,3575,3531,2524,1384,3707,633,0.145852535
E84042,8180,6889,6802,6716,4815,2313,7335,845,0.103300733
E84044,10213,8292,8172,8059,5872,3125,8730,1483,0.145207089
E84048,8479,7059,6985,6899,5005,2706,7219,1260,0.14860243
E84049,5022,3823,3753,3681,2415,1231,4489,533,0.106133015
E84051,6194,5102,5025,4958,3591,1737,5492,702,0.113335486
E84053,3997,3400,3360,3316,2390,1801,3026,971,0.242932199
E84057,14520,11429,11085,10762,7237,4722,12169,2351,0.161914601
E84058,24012,18627,18350,18061,13064,5183,21952,2060,0.085790438
E84059,4362,3643,3602,3556,2578,1380,3677,685,0.157038056
E84061,11115,9312,9185,9076,6332,4803,8628,2487,0.223751687
E84062,5045,4018,3977,3916,2822,1498,4456,589,0.116749257
E84063,6953,5937,5892,5838,4641,1209,6560,393,0.056522364
E84066,14738,12304,12147,11997,8033,3527,13494,1244,0.084407654
E84067,9026,6973,6854,6749,5111,1953,8522,504,0.055838688
E84068,15814,12620,12443,12305,9125,5147,13297,2517,0.159162767
E84069,13325,10616,10465,10299,7313,3906,11653,1672,0.125478424
E84070,4520,3705,3656,3618,2716,1549,3769,751,0.166150442
E84074,6717,5590,5527,5455,4044,1986,6042,675,0.100491291
E84075,7812,6200,6139,6078,4118,1562,7228,584,0.074756784
E84076,6658,5398,5306,5221,3682,2113,5733,925,0.13893061
E84078,4717,3994,3946,3904,2880,1729,3948,769,0.163027348
E84080,9050,7512,7425,7350,5474,2533,8044,1006,0.111160221
E84083,6115,5126,5050,4983,3707,2044,5186,929,0.151921504
E84086,8108,6882,6799,6738,4956,2126,7319,789,0.097311297
E84601,7904,6582,6519,6446,4467,1974,6990,914,0.115637652
E84617,5205,4126,4085,4034,2958,1139,4759,446,0.08568684
E84620,7011,5579,5495,5409,3956,1698,6423,588,0.083868207
E84626,3178,2565,2531,2499,1776,872,2829,349,0.109817495
E84635,5380,4271,4214,4159,3108,1253,5001,379,0.070446097
E84637,4068,2928,2885,2839,2125,756,3877,191,0.046951819
E84638,5949,4848,4753,4664,3204,1601,5329,620,0.104219197
E84645,7702,6214,6140,6062,4207,1851,7042,660,0.085692028
E84646,7561,5670,5603,5559,3805,1093,7205,356,0.047083719
E84647,3450,2857,2829,2793,2011,1186,2849,601,0.174202899
E84653,2993,2364,2327,2299,1648,666,2772,221,0.073838958
E84656,4303,3519,3478,3432,2516,1171,3871,432,0.100395073
E84658,5372,4273,4206,4148,2969,1718,4539,833,0.155063291
E84663,7574,6352,6302,6262,4180,1749,6713,861,0.113678373
E84665,9920,8095,7989,7886,5853,2706,8941,979,0.098689516
E84674,5780,4971,4927,4880,3840,1523,5268,512,0.088581315
E84676,3664,2943,2875,2811,2042,1106,3252,412,0.112445415
E84678,4314,3610,3575,3542,2623,1261,3766,548,0.12702828
E84680,4109,3265,3233,3199,2476,1063,3630,479,0.116573376
E84681,3634,2959,2926,2901,2098,850,3327,307,0.084479912
E84684,3936,3194,3156,3115,2227,1151,3432,504,0.12804878
E84685,8804,7037,6934,6835,4922,2682,7628,1176,0.133575647
E84693,8227,6514,6420,6343,4906,2217,7485,742,0.090190835
E84696,1134,968,950,930,720,337,1046,88,0.077601411
E84699,3588,2992,2954,2922,2113,1094,3112,476,0.132664437
E84701,4836,3921,3858,3794,2729,1115,4465,371,0.076716294
E84702,5603,4836,4799,4757,3022,1346,5121,482,0.086025344
E84704,2282,1835,1797,1761,1201,745,1989,293,0.128396144
E84709,12457,10441,10338,10219,6849,2789,11377,1080,0.086698242
E84713,4349,3572,3520,3481,2448,1450,3592,757,0.174063003
E85001,8750,7120,7064,6978,5145,2712,7506,1244,0.142171429
E85003,19515,17201,17074,16962,12383,4213,18043,1472,0.075429157
E85004,6982,5617,5564,5483,4107,2141,6052,930,0.133199656
E85005,3616,3123,3086,3045,2068,966,3223,393,0.108683628
E85006,4860,3814,3736,3661,2582,1150,4496,364,0.074897119
E85007,13052,10665,10506,10345,7748,4308,11255,1797,0.137680049
E85008,7890,6744,6681,6618,4708,2611,6656,1234,0.156400507
E85012,5065,4196,4138,4083,2943,1794,4231,834,0.164659427
E85013,4456,3531,3475,3422,2551,1194,4018,438,0.098294434
E85014,9421,7684,7597,7523,5866,3087,8111,1310,0.139051056
E85015,7819,6647,6582,6513,4798,2507,6626,1193,0.152577056
E85016,10463,8630,8516,8417,6237,3205,9188,1275,0.121857976
E85018,1961,1633,1610,1590,1186,649,1656,305,0.155532891
E85019,8973,7323,7229,7134,5049,2567,7847,1126,0.125487574
E85020,15280,12875,12781,12687,9515,3573,13825,1455,0.095222513
E85021,7006,5476,5372,5269,3739,1994,6289,717,0.102340851
E85023,2647,2219,2189,2168,1573,910,2210,437,0.165092558
E85024,5318,4292,4207,4144,2956,1730,4573,745,0.140090259
E85025,8541,7623,7583,7545,4525,1389,7985,556,0.065097764
E85026,13880,11559,11442,11327,8299,3987,12048,1832,0.131988473
E85028,8906,7518,7428,7321,5338,2663,7852,1054,0.118347182
E85029,13357,11819,11721,11611,8448,3357,12065,1292,0.096728307
E85030,7444,6247,6184,6122,4718,2131,6587,857,0.115126276
E85032,5020,4283,4252,4201,3071,1558,4350,670,0.133466135
E85033,11170,9744,9651,9568,6616,2854,9958,1212,0.108504924
E85034,6213,5229,5165,5128,3599,1947,5279,934,0.150329953
E85035,5450,4310,4256,4210,3090,1567,4750,700,0.128440367
E85038,5343,4514,4478,4447,3168,1385,4729,614,0.114916713
E85040,9813,8311,8226,8126,5983,3709,7937,1876,0.191174972
E85041,5732,4644,4585,4519,3444,1737,5018,714,0.124563852
E85042,5629,4798,4766,4716,3409,1362,5092,537,0.095398828
E85045,3760,3142,3102,3057,2198,1408,3116,644,0.171276596
E85046,5780,4621,4550,4493,3273,1856,4977,803,0.138927336
E85048,7507,6132,6055,5992,3927,1484,7008,499,0.066471293
E85049,7879,6278,6186,6113,4473,1873,7175,704,0.089351441
E85050,7947,6589,6511,6427,4693,2428,6945,1002,0.126085315
E85051,6069,4918,4839,4749,3388,1980,5212,857,0.141209425
E85052,7246,5936,5865,5778,4205,1999,6436,810,0.111785813
E85053,3896,3150,3104,3056,2201,1235,3389,507,0.13013347
E85054,11007,9014,8900,8767,6424,3323,9567,1440,0.130825838
E85055,12470,11064,10975,10895,7891,3217,11253,1217,0.097594226
E85056,7909,6188,6100,6010,4460,2244,7032,877,0.110886332
E85057,9952,8067,7956,7836,5836,3618,8220,1732,0.17403537
E85058,7922,6425,6340,6247,4572,2512,6775,1147,0.14478667
E85059,9050,7351,7252,7155,5502,2498,7953,1097,0.12121547
E85060,6260,5057,4995,4928,3655,1862,5507,753,0.12028754
E85061,4158,3333,3279,3235,2275,1202,3661,497,0.11952862
E85062,13587,10803,10686,10586,8147,1788,12983,604,0.044454258
E85064,4482,3516,3454,3408,2440,1400,3975,507,0.113119143
E85066,3587,2879,2850,2812,2236,1234,3032,555,0.154725397
E85069,4616,3639,3579,3518,2562,1278,4100,516,0.111785095
E85071,1671,1429,1413,1396,977,748,1313,358,0.214242968
E85074,4546,4034,4006,3978,2877,1169,4093,453,0.099648042
E85075,4484,3634,3601,3572,2838,1211,4013,471,0.105040143
E85077,3479,3107,3081,3057,2146,1037,3067,412,0.118424835
E85083,6259,4724,4629,4553,3447,1498,5743,516,0.082441285
E85088,4658,3684,3633,3577,2628,1268,4142,516,0.110777158
E85090,4374,3712,3686,3641,2726,1310,3822,552,0.126200274
E85091,1620,1417,1403,1393,1095,482,1444,176,0.108641975
E85096,8218,6742,6652,6562,5190,1948,7512,706,0.08590898
E85098,4749,3602,3545,3485,2555,1112,4333,416,0.087597389
E85099,4159,3458,3432,3402,2489,1021,3764,395,0.094974754
E85103,3857,3325,3281,3241,2429,1414,3186,671,0.173969406
E85105,1761,1448,1432,1411,1062,601,1490,271,0.153889835
E85107,7609,5981,5895,5815,4334,1993,6853,756,0.099356026
E85108,4935,3923,3859,3794,2778,1443,4328,607,0.122998987
E85109,3480,2836,2794,2759,1956,852,3164,316,0.090804598
E85111,5066,4052,3994,3942,2903,1369,4519,547,0.107974734
E85112,5526,4471,4413,4356,3228,1600,4849,677,0.122511763
E85113,7289,5910,5827,5743,4309,2198,6409,880,0.120729867
E85114,7787,6232,6140,6057,4378,2538,6685,1102,0.141517914
E85115,3292,2649,2616,2590,1898,1117,2769,523,0.158869988
E85116,6151,4839,4764,4684,3512,1680,5511,640,0.104048122
E85118,6912,5906,5852,5793,4091,2008,6078,834,0.120659722
E85119,9966,8144,8043,7939,5985,2558,9039,927,0.093016255
E85120,8349,6692,6607,6518,4969,2533,7334,1015,0.121571446
E85121,12352,10088,9958,9859,7562,3285,11160,1192,0.096502591
E85122,16068,13556,13432,13305,9560,4098,14448,1620,0.100821509
E85123,8000,6672,6622,6567,4975,1884,7270,730,0.09125
E85124,78548,77541,77491,77412,35883,2626,78105,443,0.005639864
E85125,4812,3999,3951,3904,2866,1461,4301,511,0.106192851
E85126,8219,6752,6675,6591,4834,2192,7297,922,0.112179097
E85127,9611,7737,7615,7484,5496,2800,8509,1102,0.114660285
E85128,11931,9750,9631,9522,6720,2946,10744,1187,0.099488727
E85129,6008,5040,4990,4923,3602,2043,5136,872,0.145139814
E85130,4698,3923,3885,3850,2957,1390,4190,508,0.10813112
E85600,5147,4098,4047,3990,2975,1453,4517,630,0.122401399
E85605,9013,7318,7233,7151,5264,2608,7888,1125,0.124819705
E85617,3469,3113,3085,3057,2025,719,3218,251,0.072355146
E85623,2074,1740,1725,1705,1265,512,1880,194,0.093539055
E85624,6933,5802,5723,5650,4078,2024,6112,821,0.118419155
E85625,3994,3253,3227,3183,2550,1043,3638,356,0.089133701
E85628,9002,7074,6972,6862,5309,2755,8003,999,0.110975339
E85630,3326,2812,2775,2732,1783,736,3037,289,0.086891161
E85633,7278,5906,5829,5737,4359,1927,6591,687,0.094394064
E85635,6166,5001,4948,4889,3538,1339,5644,522,0.084657801
E85636,10786,8778,8678,8564,6125,2961,9723,1063,0.098553681
E85640,3541,3108,3087,3069,2205,903,3169,372,0.105055069
E85643,5836,4409,4299,4221,3204,1374,5356,480,0.082248115
E85649,2833,2608,2591,2582,1575,506,2627,206,0.072714437
E85656,4226,3396,3347,3302,2356,1143,3770,456,0.107903455
E85657,10485,8560,8491,8414,6379,2409,9601,884,0.08431092
E85658,4089,3581,3557,3539,2752,1424,3439,650,0.158963072
E85659,1890,1566,1543,1524,1065,482,1710,180,0.095238095
E85663,10294,8421,8313,8224,6235,2442,9464,830,0.080629493
E85672,1146,1033,1028,1023,747,419,962,184,0.160558464
E85677,5293,4445,4407,4371,3161,979,4964,329,0.062157567
E85680,10798,9205,9127,9054,4966,1820,10047,751,0.069549917
E85681,8711,6638,6536,6416,4747,1971,7941,770,0.088393985
E85682,7054,5394,5293,5188,3674,1796,6422,632,0.089594556
E85683,4436,3662,3607,3551,2758,1633,3880,556,0.125338142
E85685,9597,7957,7855,7782,5482,2838,8296,1301,0.135563197
E85687,1878,1657,1647,1634,1185,357,1761,117,0.062300319
E85692,7836,6489,6428,6367,5027,2251,7023,813,0.103751914
E85693,8206,6672,6588,6492,4871,2802,7043,1163,0.141725567
E85694,3686,2924,2879,2832,2060,1018,3256,430,0.116657623
E85696,9361,8028,7968,7897,6268,1965,8803,558,0.059609016
E85697,5785,4433,4359,4289,3190,1494,5266,519,0.08971478
E85699,6064,4755,4685,4618,3259,1859,5269,795,0.131101583
E85707,4932,4156,4106,4057,2955,1783,4115,817,0.165652879
E85708,6330,5051,4990,4922,3690,1666,5744,586,0.092575039
E85712,7773,5749,5653,5533,4084,1593,7223,550,0.070757751
E85713,4544,3736,3691,3654,2707,1227,4008,536,0.117957746
E85714,3363,2765,2724,2697,2040,1105,2857,506,0.150460898
E85715,4709,3453,3396,3340,2517,966,4361,348,0.073901041
E85716,11555,9292,9174,9065,6698,2620,10648,907,0.078494158
E85718,4776,3927,3872,3813,2845,1355,4268,508,0.106365159
E85719,11972,9281,9138,9051,6857,2471,11100,872,0.072836619
E85721,2089,1576,1541,1503,1174,451,1992,97,0.0464337
E85723,4553,3486,3414,3354,2463,1139,4150,403,0.088513068
E85725,7131,5782,5704,5625,4159,2004,6373,758,0.106296452
E85726,3130,2677,2651,2635,1951,983,2693,437,0.139616613
E85734,5842,4577,4490,4417,3245,1543,5297,545,0.093289969
E85735,4218,3366,3334,3303,2492,1107,3773,445,0.105500237
E85736,6467,4998,4926,4841,3485,1929,5728,739,0.11427246
E85739,9006,6889,6781,6686,4871,2213,8126,880,0.097712636
E85740,2354,1894,1855,1824,1322,577,2135,219,0.093033135
E85743,3042,2412,2368,2320,1680,830,2768,274,0.090072321
E85744,11176,8643,8494,8361,6380,2405,10371,805,0.072029349
E85745,6755,5407,5302,5218,3914,1980,6004,751,0.111176906
E85746,4234,3324,3287,3238,2565,946,3949,285,0.067312234
E85748,6532,5297,5215,5139,3887,1159,6222,310,0.047458665
E85750,7410,5956,5871,5796,4491,1949,6586,824,0.11120108
E86001,11964,9939,9798,9662,7103,4988,9448,2516,0.210297559
E86003,4693,3488,3419,3365,2430,1100,4299,394,0.083954826
E86004,10990,8623,8500,8402,6147,3136,9750,1240,0.112829845
E86005,7045,5627,5556,5476,3949,2537,5829,1216,0.172604684
E86006,8180,6707,6638,6553,4726,3127,6583,1597,0.195232274
E86007,9361,7689,7563,7449,5392,3727,7600,1761,0.188120927
E86009,8231,6572,6493,6417,4630,2466,7053,1178,0.143117483
E86010,13398,10064,9914,9778,7259,2800,12349,1049,0.078295268
E86011,6169,4887,4820,4759,3419,2187,5134,1035,0.167774356
E86012,11598,9628,9499,9399,6653,4813,9206,2392,0.206242456
E86014,5344,4155,4100,4046,3100,1594,4707,637,0.119199102
E86015,16389,13487,13328,13150,9644,5495,13922,2467,0.150527793
E86016,6042,4844,4743,4643,3251,1848,5276,766,0.126779212
E86017,15216,12153,11997,11850,8433,3405,13957,1259,0.082741851
E86018,8877,6971,6852,6732,4755,2701,7690,1187,0.133716346
E86019,7132,5701,5596,5496,3906,2373,6035,1097,0.153813797
E86020,5252,4037,3972,3913,2829,1447,4684,568,0.108149276
E86022,6556,5517,5455,5374,3771,2829,5157,1399,0.213392312
E86024,4907,4118,4046,3978,2785,2149,3876,1031,0.210108009
E86026,6685,5291,5209,5134,3717,2071,5847,838,0.125355273
E86027,7324,5699,5623,5546,3972,2161,6382,942,0.128618241
E86028,8410,6854,6756,6681,4849,3378,6671,1739,0.206777646
E86029,10745,8237,8083,7923,5610,3101,9544,1201,0.111772918
E86030,11792,11208,11181,11144,3202,699,11531,261,0.02213365
E86033,6167,4995,4944,4880,3612,2265,5039,1128,0.182909032
E86034,2559,2043,2017,1999,1475,903,2187,372,0.145369285
E86036,7651,6166,6093,6022,4366,2908,6252,1399,0.182851915
E86038,6661,5366,5292,5240,4027,1779,6092,569,0.085422609
E86041,5315,4168,4106,4058,2973,1624,4521,794,0.149388523
E86042,6800,5246,5159,5078,3732,1651,6221,579,0.085147059
E86605,2338,1957,1932,1909,1410,943,1909,429,0.183490163
E86609,3811,2948,2906,2866,2093,829,3524,287,0.075308318
E86610,3467,2722,2686,2651,1964,1073,3105,362,0.104413037
E86612,3908,3032,2981,2933,2224,932,3596,312,0.079836233
E86615,2646,2103,2076,2040,1494,784,2330,316,0.119425548
E86618,7272,5833,5758,5703,4208,2500,6052,1220,0.167766777
E86619,3107,2387,2372,2333,1789,1002,2643,464,0.1493402
E86620,4815,3642,3588,3527,2633,1152,4359,456,0.09470405
E86625,3255,2526,2481,2426,1762,874,2902,353,0.108448541
E86626,6585,5253,5177,5093,3852,2158,5829,756,0.114806378
E86629,3625,2857,2818,2781,2054,1058,3153,472,0.130206897
E86632,6268,4937,4852,4771,3526,1771,5670,598,0.095405233
E86637,5847,4757,4684,4603,3428,1814,5180,667,0.114075594
E86640,4614,3538,3492,3457,2664,1422,3894,720,0.156046814
E87002,16479,14511,14435,14341,10385,5057,14261,2218,0.134595546
E87003,4863,4174,4135,4087,3083,1698,4184,679,0.139625745
E87004,10096,8747,8661,8590,6829,3795,8506,1590,0.157488114
E87005,7669,6797,6757,6716,5084,3035,6392,1277,0.166514539
E87006,4862,4188,4156,4111,3027,1463,4284,578,0.118881119
E87007,8419,7277,7220,7165,5734,2423,7599,820,0.097398741
E87008,9584,8192,8088,7976,5491,2676,8452,1132,0.118113523
E87009,4062,3623,3582,3556,2636,1524,3362,700,0.172328902
E87010,6735,5979,5952,5915,4672,1913,6002,733,0.108834447
E87011,7295,6102,6017,5930,4181,2274,6268,1027,0.140781357
E87013,12864,10873,10769,10682,7788,4245,10885,1979,0.153840174
E87016,9444,7940,7846,7766,5889,3628,7741,1703,0.180326133
E87021,3879,3351,3316,3278,2462,1558,3232,647,0.166795566
E87024,5297,4334,4262,4189,2932,1761,4644,653,0.123277327
E87026,2843,2470,2438,2415,1750,1085,2357,486,0.170946184
E87029,9022,7299,7216,7136,5318,2996,7773,1249,0.13843937
E87034,14266,12453,12314,12156,8501,4196,12541,1725,0.120916865
E87037,8477,7323.608761,7252.319819,7188.478976,5183.876491,2612.154512,7415,1062,0.12528017
E87038,4724,3968,3932,3893,2897,1730,4004,720,0.152413209
E87043,6826,5574,5503,5434,4216,1809,6216,610,0.089364196
E87045,4096,3789,3767,3748,2511,1375,3542,554,0.135253906
E87046,8575,7068,7008,6948,5431,2126,7785,790,0.09212828
E87047,6182,5690,5654,5620,4008,2053,5311,871,0.140892915
E87048,3143,2748,2726,2704,2170,1147,2635,508,0.161629017
E87050,2089,1824,1810,1793,1323,580,1863,226,0.108185735
E87052,3499,2981,2944,2917,2064,1074,3056,443,0.126607602
E87061,10726,8966,8918,8873,7000,2329,9827,899,0.083815029
E87063,12240,10596,10516,10432,7425,2289,11406,834,0.068137255
E87065,2853,2454,2426,2406,1754,993,2453,400,0.140203295
E87066,7602,6905,6866,6832,4963,2010,6897,705,0.092738753
E87067,10253,8885,8794,8704,6754,3732,8817,1436,0.140056569
E87069,3259,3081,3069,3060,2317,841,3023,236,0.072414851
E87070,5840,5118,5092,5056,3666,1619,5184,656,0.112328767
E87609,19669,16084,15894,15722,11703,5431,17260,2409,0.122476994
E87637,16953,14363,14210,14056,10476,4384,15414,1539,0.090780393
E87648,2464,2271,2260,2248,1605,897,2060,404,0.163961039
E87663,3269,2710,2662,2629,1931,1027,2898,371,0.113490364
E87665,5381,4527,4480,4437,3226,1912,4521,860,0.159821594
E87677,16952,16796,16781,16748,3040,540,16683,269,0.015868334
E87681,13377,11779,11713,11641,8458,3030,12188,1189,0.088883905
E87691,221,178,145,83,29,16,216,5,0.022624434
E87694,277,255,255,254,161,86,251,26,0.093862816
E87701,8722,7536,7461,7412,5519,3229,7240,1482,0.169915157
E87702,2632,2334,2323,2307,1630,934,2203,429,0.162993921
E87706,4223,3574,3530,3480,2579,1505,3655,568,0.134501539
E87711,296,296,296,296,70,295,7,289,0.976351351
E87714,4203,3868,3849,3835,2856,944,3969,234,0.055674518
E87715,8436,7093,7037,6961,5367,2456,7536,900,0.106685633
E87720,8443,7400,7314,7260,5292,1909,7877,566,0.067037783
E87722,6365,5780,5759,5730,4024,1216,5976,389,0.061115475
E87733,3724,3160,3107,3066,2223,1157,3336,388,0.104189044
E87735,1381,1167,1149,1133,822,584,1121,260,0.18826937
E87737,10752,9671,9616,9567,6306,2654,9654,1098,0.102120536
E87738,16016,13968,13854,13728,10446,5757,13667,2349,0.146665834
E87739,7537,6495,6434,6372,4623,2107,6794,743,0.098580337
E87740,2357,2356,2356,2356,2106,753,2253,104,0.044123886
E87741,3842,3238,3195,3158,2390,1158,3506,336,0.087454451
E87742,2694,2309,2277,2248,1580,913,2333,361,0.134001485
E87745,7181,6312,6279,6253,4745,2114,6343,838,0.116696839
E87746,3660,3289,3253,3198,2263,870,3389,271,0.074043716
E87750,4010,3572,3540,3507,2801,1381,3538,472,0.117705736
E87751,2127,1769,1738,1712,1215,704,1867,260,0.122237894
E87753,8995,7776,7708,7669,5766,2300,8141,854,0.094941634
E87754,7053,6081,6018,5968,4441,1720,6414,639,0.090599745
E87755,3588,2926,2864,2820,1898,885,3298,290,0.080824972
E87756,3785,3131,3078,3030,2308,1160,3388,397,0.104887715
E87762,5480,4859,4823,4778,3402,1745,4761,719,0.13120438
E87768,17386,17383,17381,17358,1913,90,17372,14,0.000805246
E87772,483,483,483,483,440,159,468,15,0.031055901
F81001,12857,10572,10449,10324,7105,5617,9822,3035,0.236058178
F81003,6069,4984,4916,4853,3552,2211,5079,990,0.163124073
F81004,9932,8100,7979,7839,5823,4233,8057,1875,0.188783729
F81006,6326,4887,4816,4720,3294,1972,5446,880,0.139108441
F81007,21022,17210,16978,16759,11828,8457,16868,4154,0.197602512
F81009,10432,8542,8421,8320,6122,4387,8216,2216,0.212423313
F81010,12459,9829,9682,9534,6949,4225,10580,1879,0.150814672
F81011,7656,6275,6181,6081,4504,3315,6029,1627,0.212513062
F81012,7622,6633,6563,6482,4452,4370,4909,2713,0.355943322
F81013,11998,9757,9626,9498,6847,4913,9549,2449,0.204117353
F81014,11113,9016,8908,8800,6233,4196,9056,2057,0.185098533
F81015,12829,10352,10179,10006,7399,5205,10414,2415,0.188245382
F81016,5336,4322,4275,4225,3223,1921,4478,858,0.160794603
F81017,8297,7272,7193,7127,4655,4966,5033,3264,0.393395203
F81019,17646,14293,14083,13865,9517,7631,13504,4142,0.234727417
F81020,7411,6282,6209,6136,4629,3762,5631,1780,0.240183511
F81021,9181,7782,7680,7583,5578,4735,6629,2552,0.277965363
F81022,14947,12441,12268,12087,8523,6810,11451,3496,0.233893089
F81023,12736,10288,10147,10001,7454,4240,10960,1776,0.139447236
F81024,5474,4418,4356,4286,3186,2166,4507,967,0.17665327
F81025,9663,7823,7728,7642,5483,3097,8358,1305,0.135051226
F81026,7368,6509,6438,6374,4074,4702,4177,3191,0.433089034
F81027,19919,15701,15462,15227,10815,6304,17065,2854,0.143280285
F81028,8603,7129,7028,6919,5054,3855,6524,2079,0.241659886
F81029,7051,5596,5531,5454,4082,2161,6125,926,0.13132889
F81030,16433,13500,13325,13159,9271,6829,12836,3597,0.218888821
F81031,7356,5700,5597,5493,3937,2288,6386,970,0.131865144
F81032,3319,2806,2763,2732,1927,1515,2526,793,0.238927388
F81034,8667,7108,7008,6897,5148,4009,6629,2038,0.235144802
F81036,18348,14771,14561,14347,10307,6946,14987,3361,0.183180728
F81037,8094,6654,6549,6462,4311,3491,6215,1879,0.23214727
F81038,13546,11263,11115,10974,7807,5825,10491,3055,0.225527831
F81040,4448,3810,3755,3706,2633,2306,3237,1211,0.272257194
F81041,12888,10751,10629,10517,7320,5753,9698,3190,0.24751707
F81042,36894,29586,29153,28744,20438,13081,30617,6277,0.170136065
F81043,19803,16319,16082,15872,11276,8625,15256,4547,0.229611675
F81044,7372,6254,6171,6098,4385,3639,5509,1863,0.252712968
F81045,3352,2744,2717,2688,1872,1472,2546,806,0.240453461
F81046,4997,4252,4208,4156,2860,2419,3647,1350,0.270162097
F81047,10804,8660,8539,8430,5982,3958,9028,1776,0.164383562
F81048,11242,9344,9201,9044,6425,4548,9167,2075,0.184575698
F81049,12158,9946,9815,9688,6847,5491,9341,2817,0.231699293
F81051,7271,5923,5851,5757,4121,2982,5762,1509,0.20753679
F81052,14499,12273,12164,12047,7915,7660,9830,4669,0.322022208
F81053,10747,8547,8427,8308,6182,3863,8953,1794,0.166930306
F81055,13400,11039,10870,10707,7578,5610,10666,2734,0.204029851
F81056,9188,7645,7559,7462,5402,3876,7225,1963,0.213648237
F81057,13149,10731,10574,10419,7363,4440,11099,2050,0.155905392
F81060,5136,3927,3867,3806,2704,1576,4462,674,0.13123053
F81061,6948,5998,5941,5881,4018,3636,4833,2115,0.304404145
F81062,8920,7215,7118,7037,4926,3233,7242,1678,0.188116592
F81065,4224,3468,3419,3369,2441,1693,3390,834,0.197443182
F81066,6134,5303,5243,5172,3472,3184,4239,1895,0.308933812
F81067,15971,13223,13053,12859,9025,6965,12208,3763,0.235614551
F81068,15660,12928,12749,12579,8872,6834,12075,3585,0.228927203
F81069,6999,5601,5523,5449,4012,2794,5604,1395,0.199314188
F81071,13301,11227,11118,11008,7122,3806,11515,1786,0.134275618
F81072,7316,5939,5881,5838,4373,2909,5859,1457,0.199152542
F81075,12821,10951,10789,10646,7367,6315,9269,3552,0.277045472
F81076,4199,3486,3448,3398,2505,1972,3168,1031,0.245534651
F81078,12220,9469,9291,9134,6948,3718,10729,1491,0.122013093
F81080,12363,10058,9902,9759,7188,5221,9726,2637,0.213297743
F81081,19908,16252,16043,15849,11337,6937,16853,3055,0.153455897
F81082,6237,5100,5033,4972,3498,2674,4741,1496,0.239858907
F81083,11940,9876,9752,9647,6754,4404,9599,2341,0.196063652
F81085,13968,11356,11190,11054,7723,5089,11367,2601,0.18621134
F81086,7924,6419,6334,6244,4393,3050,6415,1509,0.190434124
F81087,13636,11283,11115,10979,7585,5642,10616,3020,0.221472573
F81088,2776,2306,2279,2252,1596,1022,2228,548,0.19740634
F81089,10382,8693,8584,8492,5919,4833,7806,2576,0.248121749
F81090,10640,8601,8500,8394,6142,4417,8419,2221,0.208740602
F81091,9003,7429,7358,7297,5001,3164,7403,1600,0.177718538
F81092,4951,4049,3997,3962,2889,2011,3910,1041,0.210260553
F81095,18859,14571,14370,14165,10184,5966,16115,2744,0.145500822
F81096,10080,8387,8280,8162,5569,4534,7447,2633,0.261210317
F81097,17152,13959,13798,13638,9927,5890,14484,2668,0.155550373
F81098,8051,6798,6707,6623,4551,3648,6105,1946,0.241709104
F81099,13164,11172,11029,10871,7603,6447,9653,3511,0.266712246
F81100,24441,20233,19942,19618,14122,10571,19108,5333,0.218198928
F81101,5452,4760,4705,4654,3198,2736,3987,1465,0.268708731
F81102,6609,5349,5258,5178,3754,2652,5267,1342,0.203056438
F81104,5155,4227,4174,4126,2965,2242,3931,1224,0.237439379
F81105,19556,15475,15172,14855,10996,7320,16258,3298,0.168643894
F81106,10141,7985,7862,7739,5545,3492,8676,1465,0.144463071
F81108,18047,14399,14164,13951,9931,6580,14808,3239,0.179475813
F81110,11494,8618,8471,8326,5884,3571,9888,1606,0.139725074
F81111,6730,5306,5239,5175,3956,2528,5653,1077,0.160029718
F81112,13348,11027,10871,10735,7758,5963,9994,3354,0.251273599
F81113,15255,11494,11259,11044,8552,3898,14103,1152,0.075516224
F81114,12981,10650,10506,10357,7305,5610,9896,3085,0.237655034
F81115,29466,24061,23730,23451,16948,12020,23202,6264,0.212583995
F81116,10527,8857,8751,8645,5988,5070,7610,2917,0.277096989
F81117,10316,8522,8423,8321,6007,3998,8404,1912,0.185343156
F81118,14761,11638,11443,11281,8281,5759,12137,2624,0.177765734
F81119,7747,6443,6362,6281,4579,3655,5857,1890,0.243965406
F81120,13182,10255,10113,9980,7198,4356,11204,1978,0.150053103
F81121,7210,5992,5916,5840,4059,3343,5326,1884,0.261303745
F81122,28126,22613,22254,21966,15630,10529,22803,5323,0.189255493
F81123,21302,17457,17190,16979,11850,9186,16128,5174,0.242887992
F81125,13778,11810,11642,11482,8028,6645,10380,3398,0.246625054
F81126,8763,7497,7428,7341,5266,4542,6257,2506,0.285975123
F81128,15321,12807,12652,12484,8727,7074,11321,4000,0.261079564
F81130,6029,5069,4996,4945,3522,2835,4600,1429,0.237021065
F81131,8108,6681,6577,6479,4621,3645,6255,1853,0.228539714
F81132,17983,14469,14224,14006,10280,6839,14459,3524,0.195962854
F81133,11639,9806,9682,9561,6751,5631,8487,3152,0.270813644
F81134,7878,6364,6281,6186,4543,2934,6530,1348,0.171109419
F81136,11826,9376,9259,9134,6746,3754,10175,1651,0.139607644
F81137,7795,6415,6320,6240,4506,3295,6188,1607,0.206157793
F81141,17907,17213,17180,17127,3549,1802,16997,910,0.050818116
F81142,6874,5669,5606,5544,3932,2985,5257,1617,0.235234216
F81144,21257,16865,16630,16413,12096,7890,17396,3861,0.181634285
F81147,5344,4498,4443,4394,2950,2345,4057,1287,0.240830838
F81149,10751,8872,8759,8639,6371,4807,8345,2406,0.223793136
F81150,11340,8721,8595,8470,5952,3395,9919,1421,0.125308642
F81152,11704,9448,9319,9198,6596,4024,9851,1853,0.158321941
F81153,12357,10060,9902,9754,7026,4864,9859,2498,0.202152626
F81155,5347,4222,4152,4081,2893,1858,4494,853,0.159528708
F81156,8165,6631,6557,6478,4361,3574,6183,1982,0.242743417
F81158,3789,3014,2975,2942,2113,1380,3150,639,0.168646081
F81159,5802,4738,4697,4650,3125,1471,5247,555,0.09565667
F81163,6882,5729,5655,5571,3875,3078,5376,1506,0.218831735
F81164,10765,8630,8505,8395,6145,3761,9105,1660,0.154203437
F81165,4814,3963,3933,3883,2919,1881,3970,844,0.175321978
F81169,7679,6317,6241,6148,4417,3038,6185,1494,0.194556583
F81170,6136,5035,4972,4916,3678,2555,4854,1282,0.2089309
F81173,6376,4847,4776,4711,3494,1900,5427,949,0.148839398
F81176,2619,2107,2087,2063,1532,1013,2133,486,0.18556701
F81177,3978,3134,3090,3049,2160,1346,3304,674,0.169431875
F81181,16418,12770,12602,12446,8939,3996,14870,1548,0.094286758
F81183,5039,4315,4276,4236,3116,2611,3769,1270,0.252034134
F81184,3989,3331,3291,3254,2348,1842,3026,963,0.241413888
F81186,6895,5164,5068,4983,3630,1792,6116,779,0.112980421
F81192,9857,8032,7915,7808,5506,4037,7716,2141,0.217206046
F81193,5868,4673,4612,4563,3305,1942,4949,919,0.156612134
F81197,2637,2107,2073,2044,1529,884,2267,370,0.140310959
F81198,2677,2230,2201,2174,1536,1162,2103,574,0.214419126
F81205,6297,5062,4986,4918,3576,2595,5008,1289,0.204700651
F81206,5546,3993,3929,3851,2671,1550,4889,657,0.118463758
F81207,1896,1612,1601,1584,1213,660,1607,289,0.15242616
F81209,2749,2333,2312,2285,1669,1236,2126,623,0.226627865
F81211,5525,4289,4218,4145,3057,1655,4851,674,0.12199095
F81212,10142,8069,7963,7864,5446,3983,8145,1997,0.196903964
F81213,7601,6485,6405,6329,4555,4125,5186,2415,0.317721352
F81215,9514,7954,7835,7716,5346,4437,7246,2268,0.238385537
F81216,4424,3542,3468,3419,2448,1574,3749,675,0.152576854
F81218,1945,1542,1523,1501,1157,678,1665,280,0.143958869
F81219,4512,3833,3782,3729,2628,1938,3598,914,0.202570922
F81221,4797,4032,3976,3917,2786,2202,3635,1162,0.24223473
F81222,5271,4251,4184,4131,3012,1941,4490,781,0.148169228
F81223,3227,2675,2640,2605,1880,1383,2494,733,0.227145956
F81606,2886,2469,2422,2389,1726,1491,2054,832,0.288288288
F81613,7552,6073,5971,5884,4163,2873,6189,1363,0.180481992
F81618,3926,3196,3150,3096,2226,1569,3134,792,0.201732043
F81619,3625,2902,2872,2839,2098,1279,3036,589,0.162482759
F81623,2511,2014,1977,1958,1477,812,2141,370,0.147351653
F81632,3860,2931,2881,2838,2060,1084,3412,448,0.116062176
F81633,3804,3166,3140,3111,2216,1706,2915,889,0.233701367
F81635,2289,1848,1824,1805,1348,816,1907,382,0.166885103
F81636,13911,10726,10529,10387,7898,4028,12239,1672,0.120192653
F81640,4443,3396,3329,3267,2459,1341,3921,522,0.117488184
F81641,3263,2666,2628,2595,1951,1050,2779,484,0.148329758
F81645,4154,3355,3311,3260,2478,1570,3413,741,0.178382282
F81649,4119,3363,3326,3285,2384,1623,3275,844,0.204904103
F81651,3131,2588,2553,2515,1746,1295,2441,690,0.220376876
F81652,3207,2486,2443,2412,1795,1064,2749,458,0.142812597
F81656,2936,2332,2301,2265,1621,988,2528,408,0.138964578
F81665,4664,3707,3665,3619,2772,1443,4061,603,0.129288165
F81666,3728,2956,2912,2878,2205,1322,3175,553,0.14833691
F81669,6560,4706,4616,4540,3357,1366,6111,449,0.068445122
F81674,2849,2280,2256,2216,1716,1142,2365,484,0.16988417
F81675,4315,3428,3385,3352,2454,1505,3644,671,0.155504056
F81679,7315,5806,5707,5634,4036,2404,6237,1078,0.147368421
F81681,15360,13329,13171,13047,8803,8892,9686,5674,0.369401042
F81683,9826,7743,7599,7480,5513,3191,8651,1175,0.119580704
F81684,5897,4728,4651,4569,3284,2244,4929,968,0.164151263
F81688,2243,1819,1785,1759,1261,788,1955,288,0.128399465
F81690,7776,6552,6470,6403,4579,3471,5945,1831,0.235468107
F81696,2049,1805,1782,1766,1290,1035,1506,543,0.265007321
F81697,3229,2700,2679,2639,1835,1361,2537,692,0.214307835
F81700,4361,3582,3543,3504,2537,1795,3506,855,0.19605595
F81704,3542,2888,2846,2800,2090,1306,3067,475,0.134105025
F81707,3623,2623,2571,2530,1788,834,3314,309,0.085288435
F81708,10315,7824,7675,7555,5412,2828,9197,1118,0.108385846
F81711,2614,2060,2035,2017,1412,771,2277,337,0.128921194
F81713,3008,2442,2391,2346,1730,1132,2550,458,0.152260638
F81716,8199,6401,6298,6198,4577,2622,7048,1151,0.140382974
F81721,7732,6348,6257,6168,4497,3118,6285,1447,0.187144335
F81725,8572,6953,6868,6776,4838,3155,7116,1456,0.169855343
F81729,3780,2954,2902,2843,2088,1169,3286,494,0.130687831
F81730,6229,5118,5043,4968,3690,2910,4685,1544,0.247872853
F81732,7220,5877,5807,5736,4083,2873,5689,1531,0.212049861
F81737,2584,2035,1995,1961,1452,875,2244,340,0.131578947
F81739,6772,5642,5550,5487,3821,3173,5007,1765,0.260632014
F81740,3512,3048,3015,2989,1992,1905,2292,1220,0.34738041
F81741,11735,10168,10072,9963,6654,6341,7935,3800,0.32381764
F81744,2703,2219,2191,2162,1577,1187,2090,613,0.226785054
F81746,3973,2896,2845,2787,2070,822,3744,229,0.057639064
F81749,13645,10871,10747,10615,7768,4901,11355,2290,0.167827043
F81751,4499,3618,3565,3509,2627,1782,3688,811,0.180262281
F81757,6260,5126,5076,5022,3824,2746,4911,1349,0.215495208
F82001,6816,5036,4931,4825,3550,1668,6258,558,0.081866197
F82002,6352,5369,5316,5247,3709,2937,4783,1569,0.247008816
F82003,5598,4198,4126,4041,2867,1561,5012,586,0.104680243
F82005,6351,4553,4466,4391,3206,1518,5711,640,0.100771532
F82006,11937,9945,9816,9674,6545,5294,8960,2977,0.249392645
F82007,11746,9899,9789,9682,6840,5239,8975,2771,0.235910097
F82008,14828,12446,12288,12137,8577,6447,11655,3173,0.213987052
F82009,19684,15721,15498,15295,10857,7064,16136,3548,0.180247917
F82010,7757,6053,5959,5880,4385,2424,6754,1003,0.129302565
F82011,10639,8453,8363,8238,5868,3604,8920,1719,0.161575336
F82012,3917,3036,2987,2938,2105,1329,3328,589,0.150370181
F82013,17317,14154,13979,13821,9861,6259,14196,3121,0.180227522
F82014,7120,5460,5357,5281,3771,2338,6045,1075,0.150983146
F82015,5700,4320,4244,4166,3063,1466,5174,526,0.092280702
F82016,7221,5534,5444,5338,3836,2143,6331,890,0.123251627
F82017,8371,6384,6270,6142,4399,2362,7451,920,0.109903237
F82018,11402,8664,8511,8355,5775,2936,10272,1130,0.09910542
F82019,6687,5324,5254,5174,3678,2309,5610,1077,0.161058771
F82021,9887,8142,8027,7896,5584,3851,8029,1858,0.187923536
F82022,12577,10467,10322,10202,7196,5383,9905,2672,0.2124513
F82023,3342,2834,2796,2753,1956,1385,2670,672,0.201077199
F82025,5549,4074,3998,3930,2891,1388,4998,551,0.099297171
F82027,2353,1935,1911,1881,1360,853,1940,413,0.175520612
F82028,9366,7545,7442,7325,5165,3402,7744,1622,0.173179586
F82030,13413,10643,10476,10333,7302,4805,11024,2389,0.178110788
F82031,4676,3769,3717,3657,2558,1710,3874,802,0.171514115
F82033,3760,3093,3059,3021,2186,1586,2920,840,0.223404255
F82034,4972,3543,3475,3410,2645,885,4740,232,0.046661303
F82038,5567,4204,4134,4070,2914,1540,4953,614,0.110292797
F82039,3586,2847,2820,2790,1978,1201,3067,519,0.144729504
F82040,2925,2162,2127,2080,1463,615,2690,235,0.08034188
F82042,9287,6845,6723,6611,4908,1921,8683,604,0.065037149
F82045,3523,2930,2892,2859,2009,1442,2737,786,0.223105308
F82051,9773,7367,7236,7107,5067,2563,8733,1040,0.106415635
F82053,4246,3551,3480,3435,2428,1743,3368,878,0.206782854
F82055,7940,6306,6238,6170,4446,2603,6746,1194,0.150377834
F82604,5083,3615,3525,3455,2499,1176,4615,468,0.092071611
F82607,5043,3955,3902,3847,2689,1755,4164,879,0.174301011
F82609,4472,3800,3767,3734,2522,2094,3318,1154,0.258050089
F82610,2988,2423,2382,2357,1708,1130,2439,549,0.18373494
F82612,5879,4467,4381,4316,3099,1498,5248,631,0.107331179
F82619,2724,2183,2146,2116,1464,1086,2127,597,0.219162996
F82621,4005,2996,2950,2903,2082,995,3606,399,0.099625468
F82624,3830,3177,3141,3100,2218,1643,2963,867,0.226370757
F82625,6947,5217,5104,5001,3710,1405,6511,436,0.062760904
F82627,5128,3886,3805,3742,2661,1544,4480,648,0.126365055
F82630,6495,5102,5029,4935,3491,2342,5379,1116,0.17182448
F82634,5064,3781,3727,3673,2677,1085,4731,333,0.065758294
F82638,6244,4755,4691,4638,3315,1668,5567,677,0.108424087
F82642,6951,5235,5145,5046,3665,1803,6254,697,0.100273342
F82647,4669,3906,3861,3821,2871,1135,4257,412,0.088241593
F82648,3308,2567,2531,2487,1837,1057,2847,461,0.139359129
F82649,4730,3952,3906,3868,2720,1985,3783,947,0.200211416
F82650,8609,6422,6303,6203,4545,1772,8054,555,0.064467418
F82660,21083,15704,15403,15081,11060,5231,19257,1826,0.086610065
F82661,3782,2885,2836,2796,2137,892,3510,272,0.071919619
F82663,3677,3002,2963,2931,2135,1180,3152,525,0.14277944
F82666,4631,3776,3728,3669,2693,1719,3849,782,0.168862017
F82670,2842,2101,2075,2037,1455,669,2633,209,0.073539761
F82671,3051,2350,2306,2267,1555,967,2627,424,0.138970829
F82674,5053,3978,3906,3839,2674,1815,4163,890,0.17613299
F82675,3734,3183,3127,3097,2114,1666,2897,837,0.224156401
F82676,8841,6134,5998,5877,4386,1459,8491,350,0.039588282
F82677,6993,5071,4975,4877,3532,1620,6439,554,0.079222079
F82678,4826,3736,3674,3594,2554,1495,4177,649,0.134479901
F82679,4712,3591,3517,3434,2443,1271,4252,460,0.09762309
F82680,8173,6342,6249,6156,4538,2091,7357,816,0.09984094
F82686,3231,2527,2480,2444,1794,877,2951,280,0.086660477
F83002,10035,8394,8314,8227,6025,2409,9110,925,0.092177379
F83003,7195,6154,6097,6008,4421,2739,5850,1345,0.186935372
F83004,9207,8511,8452,8377,4936,1695,8615,592,0.064298903
F83005,8684,8541,8534,8521,2262,552,8410,274,0.03155228
F83006,7860,6487,6414,6321,4493,2245,7030,830,0.105597964
F83007,3410,2974,2938,2899,2152,1199,2911,499,0.146334311
F83008,12235,10404,10305,10212,7044,3219,10947,1288,0.105271761
F83010,19604,16580,16471,16351,12617,4299,17970,1634,0.083350337
F83011,6678,5586,5543,5494,4248,2291,5666,1012,0.151542378
F83012,7673,6615,6555,6509,4914,2327,6647,1026,0.133715626
F83015,12628,10596,10492,10392,7708,3621,11190,1438,0.113873931
F83017,15939,13534,13411,13282,9820,4100,14213,1726,0.108287847
F83018,8905,7488,7395,7290,5075,2371,7987,918,0.103088153
F83019,12001,9997,9864,9757,7254,3221,10605,1396,0.11632364
F83020,11835,10119,10033,9942,7255,3366,10257,1578,0.133333333
F83021,18483,16642,16550,16442,11237,3618,17090,1393,0.075366553
F83022,15757,13485,13337,13206,9306,4254,13944,1813,0.115059973
F83023,21891,18338,18094,17874,12767,5812,19702,2189,0.099995432
F83025,6080,4788,4704,4627,3250,1592,5475,605,0.099506579
F83027,5321,4441,4396,4350,3151,1370,4754,567,0.106558917
F83032,12091,10406,10342,10274,7789,2761,11104,987,0.081630965
F83033,3242,2626,2590,2564,1730,1011,2809,433,0.133559531
F83034,1650,1566,1558,1550,1160,630,1353,297,0.18
F83039,5110,4271,4210,4164,3086,1764,4434,676,0.132289628
F83042,7185,6712,6677,6651,3294,1088,6798,387,0.053862213
F83043,18895,18832,18828,18790,2445,411,18707,188,0.009949722
F83044,4290,3753,3717,3690,2609,1043,3871,419,0.097668998
F83045,10643,9160,9072,8976,6903,3013,9476,1167,0.109649535
F83048,6857,6149,6115,6067,3414,1337,6330,527,0.076855768
F83050,2874,2533,2503,2475,1902,1013,2403,471,0.16388309
F83052,3581,2988,2944,2905,2111,1231,3075,506,0.141301312
F83053,6287,5229,5155,5087,3766,1572,5739,548,0.087163989
F83055,17354,15213,15099,14999,9917,2905,16147,1207,0.069551688
F83056,5987,5256,5219,5185,3464,1090,5635,352,0.058794054
F83057,7754,6731,6653,6589,4510,2010,6984,770,0.099303585
F83058,12288,11547,11491,11409,5106,1506,11693,595,0.048421224
F83059,18942,16373,16248,16116,11958,3979,17519,1423,0.075124063
F83060,9137,7712,7634,7561,5385,2092,8312,825,0.090292218
F83061,5257,4804,4775,4745,3163,1366,4704,553,0.105193076
F83063,12315,10526,10424,10328,6875,2354,11490,825,0.066991474
F83064,7969,6829,6775,6716,4098,1589,7360,609,0.076421132
F83615,8022,6491,6411,6346,4895,1932,7139,883,0.110072301
F83623,12596,9663,9544,9416,7377,3708,11016,1580,0.125436647
F83624,14121,12858,12793,12708,6372,1900,13622,499,0.035337441
F83632,5609,4673,4606,4543,2883,1310,5082,527,0.093956142
F83633,3508,2956,2929,2908,2075,902,3123,385,0.109749145
F83635,6810,6281,6258,6220,3042,611,6616,194,0.028487518
F83652,10637,9254,9194,9128,6039,2156,9928,709,0.066654132
F83658,4363,3609,3568,3514,2584,1216,3872,491,0.112537245
F83660,9310,7378,7298,7209,5476,2234,8520,790,0.084854995
F83664,9084,7771,7707,7642,5312,1671,8600,484,0.053280493
F83665,14692,12143,12009,11905,8694,2527,13781,911,0.062006534
F83666,6574,5550,5499,5456,3634,1490,5923,651,0.099026468
F83671,3016,2471,2445,2415,1709,774,2786,230,0.076259947
F83672,11866,11785,11783,11774,3800,374,11745,121,0.010197202
F83673,5682,4867,4813,4761,3080,1263,5287,395,0.069517775
F83674,9672,8456,8373,8299,6078,2823,8573,1099,0.113626964
F83677,1672,1540,1532,1521,1107,415,1521,151,0.090311005
F83678,2456,2135,2125,2099,1550,933,2051,405,0.16490228
F83680,4314,3916,3895,3875,2540,982,3966,348,0.080667594
F83681,4029,3554,3524,3508,2438,1047,3615,414,0.102755026
F83682,1911,1613,1581,1561,1219,672,1678,233,0.121925693
F83683,4793,4091,4027,3983,2172,816,4516,277,0.057792614
F83686,6858,6113,6080,6033,4142,1241,6465,393,0.057305337
F84003,15345,12478,12299,12151,8885,4043,13887,1458,0.095014663
F84004,13879,10603,10399,10189,7203,3341,12625,1254,0.090352331
F84006,14661,11415,11234,11060,8044,3174,13543,1118,0.076256736
F84008,13010,10717,10608,10476,8231,3662,11701,1309,0.100614912
F84009,10495,8798,8707,8632,6260,2009,9820,675,0.064316341
F84010,10603,8283,8148,8031,5843,2476,9715,888,0.083749882
F84012,9191,7394,7302,7225,4922,1498,8655,536,0.05831792
F84013,15397,9296,9040,8770,5566,2428,14340,1057,0.068649737
F84014,7936,6361,6263,6167,4180,1863,7171,765,0.096396169
F84015,5698,4536,4447,4377,3079,1615,5147,551,0.096700597
F84016,11872,9789,9651,9549,6496,2247,10999,873,0.073534367
F84017,20019,16179,15972,15764,10945,4171,18685,1334,0.066636695
F84018,12054,9647,9534,9387,6953,2473,11270,784,0.06504065
F84021,10465,8789,8691,8616,6681,2061,9836,629,0.060105112
F84022,7284,6248,6194,6146,4282,1440,6760,524,0.071938495
F84025,11439,8849,8685,8559,5775,1910,10744,695,0.060757059
F84030,3720,3195,3173,3145,2178,799,3418,302,0.081182796
F84031,12888,10374,10236,10099,6687,2579,11801,1087,0.084342024
F84033,12016,10013,9884,9759,7488,2757,11168,848,0.07057257
F84034,13264,10499,10333,10169,7381,3055,12159,1105,0.083308203
F84035,9771,8828,8787,8748,5715,1179,9382,389,0.039811688
F84036,7165,6034,5988,5922,4370,1739,6577,588,0.082065597
F84038,4240,3672,3644,3605,2579,1043,3875,365,0.086084906
F84039,13008,10692,10570,10443,6177,1591,12471,537,0.041282288
F84041,7727,6707,6647,6595,4959,2062,7005,722,0.093438592
F84044,7184,5906,5841,5764,3828,1119,6806,378,0.052616927
F84046,3591,2938,2900,2864,1751,460,3436,155,0.043163464
F84047,9411,7316,7192,7057,5066,2327,8607,804,0.085431941
F84050,10952,8237,8051,7882,5636,1964,10385,567,0.051771366
F84051,5567,4940,4900,4852,3094,817,5281,286,0.051374169
F84052,12673,10066,9925,9791,7276,2965,11700,973,0.076777401
F84053,8199,6666,6573,6481,4772,2068,7524,675,0.082327113
F84054,11068,8937,8828,8708,6080,2145,10333,735,0.066407662
F84055,3971,3481,3458,3423,2463,722,3679,292,0.073533115
F84060,4876,4119,4067,4018,2948,1387,4405,471,0.09659557
F84062,15075,11677,11457,11266,7818,2858,14007,1068,0.070845771
F84063,6039,5238,5189,5146,3673,1455,5542,497,0.082298394
F84069,14260,11699,11561,11439,8690,3367,13119,1141,0.080014025
F84070,6972,5488,5412,5337,3853,1491,6400,572,0.082042456
F84072,11159,9627,9574,9531,7374,1261,10782,377,0.033784389
F84074,11286,9157,9038,8918,6499,2651,10255,1031,0.091352118
F84077,9526,7844,7773,7693,5538,1994,8807,719,0.07547764
F84079,10993,9467,9405,9354,7008,2287,10206,787,0.071591012
F84080,5067,3852,3778,3717,2660,1494,4501,566,0.111703177
F84081,14110,12128,12002,11892,7157,2086,13365,745,0.052799433
F84083,8247,6781,6700,6610,4423,1772,7561,686,0.083181763
F84086,7156,5818,5752,5685,4179,2111,6377,779,0.108859698
F84087,9710,7468,7326,7210,4831,1744,9068,642,0.066117405
F84088,4967,4009,3963,3929,2716,1095,4501,466,0.093819207
F84092,8436,6479,6369,6262,4548,1780,7884,552,0.065433855
F84093,17876,14043,13838,13663,10309,3889,16708,1168,0.065339002
F84096,12930,10697,10549,10424,7602,2848,11971,959,0.0741686
F84097,10960,8451,8313,8204,6021,2510,10032,928,0.084671533
F84105,11495,9288,9152,9047,6641,2415,10723,772,0.067159635
F84111,9845,8027,7926,7790,5456,2124,9212,633,0.064296597
F84114,6621,5523,5466,5405,3790,919,6308,313,0.047273826
F84115,8701,7343,7246,7173,5581,2082,8069,632,0.072635329
F84117,10056,8479,8383,8299,6308,2399,9188,868,0.086316627
F84118,5663,4983,4938,4907,3163,828,5374,289,0.051033021
F84119,12697,10616,10517,10418,7631,2521,11877,820,0.064582185
F84121,13884,10236,10042,9825,7047,2672,12933,951,0.068496111
F84122,15640,12605,12423,12241,7961,2902,14565,1075,0.068734015
F84123,14990,13266,13171,13082,4553,1388,14537,453,0.030220147
F84124,5161,4085,4039,3988,2901,827,4967,194,0.037589614
F84601,7022,5708,5619,5535,3962,1538,6583,439,0.062517801
F84619,4702,3728,3689,3627,2688,970,4400,302,0.064227988
F84620,6995,5686,5598,5517,3922,1866,6293,702,0.100357398
F84621,4057,3391,3340,3305,2373,1137,3633,424,0.104510722
F84632,1012,1012,1012,1012,889,345,969,43,0.042490119
F84635,9218,7878,7797,7732,5121,1596,8735,483,0.052397483
F84636,5768,5119,5087,5053,3412,943,5468,300,0.052011096
F84640,9507,8742,8712,8681,6189,2982,8184,1323,0.139160618
F84641,3220,2684,2646,2607,1897,907,2864,356,0.110559006
F84642,6879,5822,5767,5713,3967,1074,6568,311,0.04521006
F84647,8789,7491,7411,7344,5027,1046,8480,309,0.035157583
F84656,9556,8164,8118,8082,5471,1401,9082,474,0.049602344
F84657,4123,3234,3184,3150,2285,1071,3704,419,0.10162503
F84658,11388,9058,8927,8782,6473,2850,10362,1026,0.090094837
F84660,2547,2130,2114,2094,1575,397,2443,104,0.040832352
F84666,5796,4750,4692,4644,3307,932,5545,251,0.043305728
F84668,7014,4801,4691,4561,3010,1084,6681,333,0.047476476
F84669,10136,7701,7559,7414,5386,2026,9455,681,0.067186267
F84670,4548,3486,3412,3335,2318,829,4277,271,0.059586631
F84672,5190,4405,4363,4302,2986,1352,4730,460,0.088631985
F84673,1972,1681,1666,1648,1337,435,1882,90,0.045638945
F84676,4240,3457,3410,3354,2334,683,4042,198,0.046698113
F84677,6317,4875,4794,4698,3322,1522,5718,599,0.094823492
F84681,5887,4617,4522,4436,3154,1471,5444,443,0.075250552
F84682,11002,8735,8626,8528,5778,1677,10408,594,0.053990184
F84685,3058,2348,2307,2274,1740,830,2798,260,0.085022891
F84686,7991,4432,4259,4096,2333,872,7632,359,0.044925541
F84692,7331,6422,6389,6337,3616,1140,6975,356,0.048560906
F84694,4369,3885,3862,3834,2601,728,4156,213,0.048752575
F84696,5345,4561,4528,4501,3290,952,4978,367,0.068662301
F84698,9126,7248,7154,7047,4526,1019,8874,252,0.027613412
F84706,2051,1641,1618,1597,1142,454,1951,100,0.048756704
F84710,12026,9937,9803,9692,6925,2432,11161,865,0.07192749
F84711,2038,1710,1690,1665,1190,562,1859,179,0.087831207
F84714,14303,11132,10968,10800,6933,1752,13736,567,0.039642033
F84716,5609,4209,4131,4070,2726,906,5219,390,0.069531111
F84717,10982,9067,8972,8887,5649,1790,10481,501,0.045620106
F84718,15073,12984,12865,12748,8163,1754,14525,548,0.036356399
F84719,5454,4659,4612,4566,3147,1481,4932,522,0.095709571
F84720,5565,4346,4257,4181,2947,1505,4981,584,0.104941599
F84724,16404,12830,12662,12507,9370,2725,15713,691,0.042123872
F84729,4899,3703,3624,3553,2632,818,4672,227,0.046335987
F84730,9641,7906,7814,7736,5732,1880,9163,478,0.049579919
F84731,2186,1983.855948,1974.713755,1969.634758,1490.177509,655.1905204,1934,252,0.115279048
F84733,1083,1083,1083,1083,983,322,1039,44,0.040627886
F84734,5946,4898,4850,4803,3823,1141,5628,318,0.053481332
F84735,8775,6491,6362,6209,4570,1807,8203,572,0.065185185
F84739,4923,3832,3749,3665,2769,734,4779,144,0.029250457
F84740,4710,3871,3828,3766,2883,910,4534,176,0.037367304
F84741,2203,1774,1753,1731,1230,602,1949,254,0.115297322
F84742,2461,2054,2017,1988,1469,550,2277,184,0.074766355
F84747,23804,19575,19377,19219,13919,2690,23102,702,0.029490842
F84749,16158,12822,12654,12490,8308,2211,15555,603,0.037318975
F85002,13304,9981,9788,9596,6772,3618,11879,1425,0.107110643
F85003,8389,6493,6348,6241,4326,2701,7313,1076,0.128263202
F85004,13435,10461,10276,10094,7306,4264,11701,1734,0.129065873
F85007,16399,13550,13365,13202,9915,4343,14976,1423,0.086773584
F85008,14435,12037,11886,11728,8510,4075,12997,1438,0.099618982
F85010,5152,4136,4050,3985,2826,1795,4351,801,0.155473602
F85013,9818,7892,7757,7642,5600,2470,9047,771,0.078529232
F85014,16071,13550,13399,13246,9861,5473,13481,2590,0.161159853
F85016,6730,5632,5556,5479,3868,2800,5286,1444,0.214561664
F85017,6937,5728,5645,5559,4087,2151,6163,774,0.111575609
F85019,13318,10575,10391,10186,7345,3881,11960,1358,0.101967262
F85020,8995,7355,7258,7162,5329,3329,7478,1517,0.16864925
F85023,10318,7207,7044,6903,4815,1998,9651,667,0.064644311
F85024,2189,1668,1640,1615,1174,655,1904,285,0.130196437
F85025,11268,9114,8991,8853,6552,4187,9267,2001,0.177582535
F85027,11665,9466,9330,9207,6663,4584,9515,2150,0.184312045
F85028,7968,6622,6523,6439,4675,2361,7155,813,0.102033133
F85029,13189,10800,10680,10573,7711,5248,10446,2743,0.207976344
F85030,13461,10482,10312,10114,7139,3753,12098,1363,0.101255479
F85031,11180,9366,9245,9144,6711,2852,10129,1051,0.094007156
F85032,10058,7987,7887,7755,5639,3143,8555,1503,0.149433287
F85033,17109,13972,13828,13668,10014,6612,13792,3317,0.193874569
F85034,4734,4053,4007,3972,2863,1435,4127,607,0.128221377
F85035,10907,8626,8478,8364,6053,4094,8950,1957,0.179426057
F85036,4452,3537,3475,3425,2535,1462,3838,614,0.137915544
F85039,5781,4257,4176,4108,2855,1339,5264,517,0.089430894
F85043,4158,3193,3127,3067,2186,1022,3807,351,0.084415584
F85044,5697,4378,4300,4231,2954,1566,5116,581,0.1019835
F85045,4426,3545,3466,3392,2607,1731,3688,738,0.166741979
F85046,4376,3823,3783,3749,2705,1024,4040,336,0.07678245
F85048,5218,3911,3825,3737,2599,1410,4676,542,0.103871215
F85052,1930,1657,1635,1617,1162,647,1658,272,0.140932642
F85053,5578,4642,4580,4504,3389,2181,4751,827,0.148261025
F85055,4852,3957,3890,3843,2779,1870,3946,906,0.186727123
F85058,6716,5315,5219,5126,3603,2134,5866,850,0.126563431
F85060,6250,5278,5222,5181,3737,1604,5638,612,0.09792
F85061,3494,2974.04804,2944.143567,2917.133076,2371.135284,1156.62783,3013,481,0.137664568
F85063,14602,11780,11617,11455,8751,4670,12542,2060,0.141076565
F85064,5641,4892,4860,4828,3319,1454,5032,609,0.107959582
F85065,3276,2755,2724,2693,1886,913,2912,364,0.111111111
F85066,18218,14881,14704,14538,11147,5234,16246,1972,0.108244593
F85067,4416,3913,3875,3844,2861,1541,3802,614,0.139039855
F85069,8488,7091,7003,6940,5437,2764,7434,1054,0.124175306
F85071,10406,8214,8111,7987,5553,2337,9670,736,0.070728426
F85072,10687,8692,8569,8460,6130,3463,9067,1620,0.151586039
F85076,12282,9589,9407,9228,6448,3752,10784,1498,0.121967106
F85615,5501,4317,4248,4184,3057,1350,5116,385,0.069987275
F85623,4714,3935,3883,3830,2669,1231,4314,400,0.084853627
F85625,6444,5280,5218,5141,3750,2440,5420,1024,0.158907511
F85628,4945,3964,3909,3857,2734,1236,4478,467,0.094438827
F85634,3250,2428,2368,2300,1653,694,3036,214,0.065846154
F85640,6718,5519,5471,5413,4230,1750,6038,680,0.101220601
F85642,8878,7126,7039,6951,5221,2899,7595,1283,0.14451453
F85650,5081,4097,4039,3978,2851,1636,4315,766,0.150757725
F85652,4413,3500,3444,3399,2585,1425,3878,535,0.121232722
F85654,4150,3254,3207,3145,2169,1321,3605,545,0.131325301
F85656,2185,1795,1779,1760,1355,797,1838,347,0.158810069
F85663,4545,3644,3575,3515,2473,1601,3909,636,0.139933993
F85666,3723,2987,2927,2880,2105,1231,3276,447,0.120064464
F85669,16586,14163,14018,13860,9360,2302,16014,572,0.034486917
F85675,5618,4667,4602,4540,3391,1975,4800,818,0.145603418
F85676,5164,3856,3783,3723,2663,1413,4607,557,0.107862122
F85678,4379,3422,3374,3320,2487,1047,4041,338,0.077186572
F85681,2234,1724,1690,1648,1120,652,1977,257,0.115040286
F85682,4607,3567,3494,3429,2441,1321,4177,430,0.093336227
F85684,5509,4271,4175,4108,2916,1500,5025,484,0.087856235
F85686,2906,2360,2315,2265,1650,964,2508,398,0.136958018
F85687,7511,6082,5999,5903,4286,2492,6432,1079,0.143655971
F85688,7043,5609,5532,5445,4055,1892,6368,675,0.095839841
F85697,2086,1809,1799,1778,1357,617,1816,270,0.129434324
F85700,6460,5235,5181,5106,3561,1397,5950,510,0.078947368
F85701,11267,8964,8846,8724,6410,2650,10153,1114,0.098872814
F85703,8277,6144,6020,5890,4191,1789,7686,591,0.071402682
F85705,12883,10514,10400,10283,7426,3014,11862,1021,0.079251727
F85707,3731,2642,2575,2509,1873,739,3544,187,0.050120611
F86001,7961,6462,6375,6297,4814,2408,7089,872,0.109533978
F86004,15863,12693,12493,12318,9089,5463,13475,2388,0.15053899
F86005,8696,6774,6694,6602,5079,1876,8051,645,0.074172033
F86006,6477,5182,5108,5046,3795,1853,5816,661,0.10205342
F86007,12778,10035,9903,9770,7235,3828,11117,1661,0.129989044
F86008,9919,7860,7758,7653,5375,2443,8670,1249,0.125919952
F86009,7589,6287,6185,6082,4293,2700,6336,1253,0.165107392
F86010,13702,11068,10900,10756,7564,4470,11607,2095,0.152897387
F86011,9667,7968,7858,7741,5586,2728,8677,990,0.102410262
F86012,10505,8835,8709,8598,6104,4494,8329,2176,0.207139457
F86013,6686,5340,5259,5189,3873,2172,5763,923,0.138049656
F86018,10072,8058,7922,7786,5707,3073,8821,1251,0.124205719
F86020,5980,4934,4886,4851,3630,2131,4921,1059,0.177090301
F86022,14213,11088,10895,10719,7823,3308,12862,1351,0.095053824
F86023,9281,7620,7542,7465,5596,3185,7721,1560,0.168085336
F86025,16123,12108,11892,11685,8436,3495,14830,1293,0.080195993
F86026,7353,5804,5699,5618,4158,2104,6553,800,0.10879913
F86028,10360,7643,7500,7365,5312,2515,9378,982,0.094787645
F86030,8367,6592,6500,6403,4632,1584,7763,604,0.072188359
F86032,9281,7516,7441,7354,5557,3066,7832,1449,0.156125418
F86034,5613,4315,4250,4160,3029,1434,5008,605,0.107785498
F86036,15841,12785,12628,12495,9684,3946,14372,1469,0.092734045
F86038,12263,9433,9269,9103,6670,2545,11468,795,0.064829161
F86040,5022,3778,3716,3653,2706,1130,4640,382,0.076065313
F86042,6363,4601,4527,4450,3392,1165,5894,469,0.073707371
F86044,9629,7983,7918,7848,5617,1751,9015,614,0.063765708
F86045,1992,1697,1679,1661,1271,569,1781,211,0.105923695
F86057,6605,5294,5213,5143,3636,2147,5660,945,0.143073429
F86058,15612,12189,12009,11862,8919,3015,14707,905,0.05796823
F86060,15768,12093,11893,11671,8445,3729,14219,1549,0.098236936
F86062,7313,6027,5953,5873,4401,1962,6556,757,0.10351429
F86064,4806,3883,3815,3747,2777,1658,4139,667,0.138784852
F86066,8240,6668,6578,6498,4838,2585,7110,1130,0.137135922
F86074,15487,12327,12153,12012,8864,3085,14480,1007,0.065022277
F86078,7140,6033,5964,5886,4070,3081,5636,1504,0.210644258
F86081,6311,4989,4896,4815,3462,1833,5493,818,0.129614958
F86082,5543,4272,4194,4126,3043,1338,4987,556,0.100306693
F86083,6776,5671,5580,5481,3872,2280,5715,1061,0.156582054
F86085,2905,2379,2340,2301,1716,901,2546,359,0.123580034
F86086,6361,4807,4731,4650,3486,1337,5949,412,0.06476969
F86087,7608,5785,5663,5552,4120,1732,6901,707,0.092928496
F86088,4877,4129,4072,4028,2931,1455,4310,567,0.116259996
F86607,14031,10792,10652,10529,8209,3085,13036,995,0.070914404
F86612,3514,2792,2751,2706,1909,1133,2990,524,0.149117814
F86616,7276,5663,5598,5527,4080,2072,6310,966,0.132765256
F86621,5982,5073,5016,4972,3644,1525,5373,609,0.101805416
F86624,3258,2622,2592,2543,1786,1182,2704,554,0.170042971
F86625,6094,4960,4868,4793,3571,1777,5472,622,0.102067607
F86626,5973,4774,4711,4641,3498,1162,5607,366,0.061275741
F86627,13592,11135,10970,10798,7636,4984,11482,2110,0.155238376
F86637,5015,4045,3994,3924,2896,1675,4273,742,0.147956132
F86638,5183,4130,4074,4019,2909,1623,4456,727,0.140266255
F86641,7695,6073,6004,5952,4764,1961,6922,773,0.100454841
F86642,4811,3687,3627,3565,2584,1002,4432,379,0.078777801
F86644,10197,7998,7859,7731,5808,2610,9268,929,0.091105227
F86650,8012,6476,6397,6307,4719,2044,7253,759,0.094732901
F86652,6781,5156,5072,4991,3591,1689,6046,735,0.108391093
F86657,8316,6434,6362,6284,4869,1603,7772,544,0.065416065
F86658,4899,3822,3770,3719,2782,1279,4340,559,0.114104919
F86664,8409,6681,6581,6481,4617,2706,7248,1161,0.138066357
F86666,14736,11905,11741,11604,8531,3318,13642,1094,0.074239957
F86679,6086,4594,4516,4447,3356,1050,5791,295,0.048471903
F86689,4302,3310,3274,3245,2699,843,4029,273,0.063458856
F86691,10917,8711,8554,8396,5964,3444,9422,1495,0.136942383
F86692,10498,7689,7542,7395,5368,2148,9746,752,0.071632692
F86696,6076,4969,4908,4857,3487,1223,5672,404,0.066491113
F86698,4655,3689,3643,3574,2599,1215,4173,482,0.103544576
F86700,3888,3148,3108,3064,2169,1486,3085,803,0.206532922
F86701,3503,2866,2836,2797,2072,898,3187,316,0.090208393
F86702,4956,3806,3749,3702,2687,1420,4261,695,0.14023406
F86703,3772,2915,2856,2796,1950,978,3408,364,0.09650053
F86705,3250,2689,2659,2634,1976,755,2998,252,0.077538462
F86707,6760,5315,5220,5151,3634,1805,6035,725,0.107248521
F86708,2761,2190,2140,2090,1517,844,2491,270,0.097790656
F86712,3394,2891,2864,2832,2026,792,3074,320,0.094284031
F86731,3890,3123,3085,3043,2289,1350,3325,565,0.145244216
G81001,9113,7399,7287,7188,5047,3586,7324,1789,0.19631296
G81002,6620,5648,5591,5519,3730,2885,5045,1575,0.237915408
G81003,16817,13967,13682,13437,9001,7402,12519,4298,0.255574716
G81004,11034,9452,9359,9273,6246,5947,7363,3671,0.332698931
G81006,6406,5721,5670,5631,4093,2158,5533,873,0.136278489
G81007,9600,7917,7781,7650,5621,4482,7361,2239,0.233229167
G81008,13418,11055,10920,10779,7568,6137,10071,3347,0.249441049
G81011,14465,12434,12294,12149,8831,4780,12670,1795,0.124092637
G81012,6335,5119,5053,4992,3429,2744,4721,1614,0.254775059
G81014,7660,6332,6243,6167,3899,2612,6410,1250,0.163185379
G81016,9838,7901,7801,7705,5506,3783,7939,1899,0.193027038
G81017,11359,9371,9242,9128,6604,4436,9327,2032,0.178888987
G81018,11783,9630,9463,9304,7101,3717,10409,1374,0.116608674
G81019,11074,9267,9167,9054,6412,5382,8180,2894,0.261332852
G81021,8249,6897,6808,6719,4839,3690,6455,1794,0.217480907
G81022,13997,11548,11394,11276,7798,6554,10192,3805,0.271843967
G81023,8162,6867,6756,6656,4683,4111,5871,2291,0.280691007
G81024,9974,8277,8153,8034,5878,4734,7634,2340,0.234609986
G81025,8953,7642,7563,7487,5072,4581,6213,2740,0.306042667
G81026,7810,6452,6394,6319,4727,3079,6380,1430,0.183098592
G81027,4576,3947,3913,3886,2691,2108,3382,1194,0.260926573
G81028,12447,10379,10220,10078,7315,3746,11201,1246,0.100104443
G81029,17900,15413,15263,15095,10189,9815,11835,6065,0.338826816
G81030,8667,7194,7085,6992,5006,4296,6485,2182,0.251759548
G81031,11182,9193,9045,8888,6292,4993,8519,2663,0.238150599
G81032,11192,9174,9047,8924,6280,5145,8484,2708,0.241958542
G81034,25876,21678,21311,20849,15498,8135,22678,3198,0.123589426
G81035,10201,8469,8339,8232,5894,4803,7570,2631,0.257915891
G81036,9245,7594,7482,7368,5222,3941,7275,1970,0.213088156
G81037,8018,6631,6551,6471,4847,3495,6181,1837,0.229109504
G81038,19822,17415,17267,17086,9241,4758,17823,1999,0.100847543
G81039,17136,15121,15003,14856,9567,10372,10230,6906,0.403011204
G81040,3496,2815,2759,2697,1925,1661,2619,877,0.250858124
G81041,14077,11879,11747,11615,7700,7155,9771,4306,0.305889039
G81042,13675,11392,11231,11054,8231,5425,11428,2247,0.164314442
G81043,7001,5846,5765,5674,4201,3229,5458,1543,0.220397086
G81044,5863,5160,5108,5074,4030,1901,5181,682,0.116322702
G81045,10067,8320,8157,8004,5923,4483,8058,2009,0.199562928
G81046,11864,9795,9642,9514,6964,4584,9843,2021,0.170347269
G81047,7568,6721,6666,6616,5105,2380,6701,867,0.114561311
G81048,7809,6736,6659,6593,4986,3847,5896,1913,0.244973748
G81049,6939,5682,5606,5527,3849,3008,5282,1657,0.238795215
G81050,11856,10235,10126,9997,6803,6057,8316,3540,0.298582996
G81051,7011,6109,6050,5986,4255,4005,4680,2331,0.332477535
G81052,4123,3505,3454,3398,2470,2238,2962,1161,0.281591074
G81053,6678,5720,5675,5606,3925,3354,4715,1963,0.293950285
G81054,10018,9045,8988,8920,6738,3785,8487,1531,0.152824915
G81055,9034,7681,7589,7482,5318,4543,6443,2591,0.286805402
G81056,7902,7028,6956,6903,3917,3191,6085,1817,0.229941787
G81057,6317,5418,5348,5293,3712,3439,4381,1936,0.306474592
G81059,11546,9555,9431,9315,6325,5315,8569,2977,0.257838212
G81061,6171,4993,4936,4866,3447,2541,4913,1258,0.203856749
G81065,9029,7363,7269,7172,5094,3861,7032,1997,0.22117621
G81070,23557,19832,19632,19444,14525,7928,20175,3382,0.143566668
G81071,21898,21633,21613,21593,5070,356,21824,74,0.003379304
G81073,8208,6502,6402,6296,4603,2831,6877,1331,0.162158869
G81074,17757,14400,14190,13968,10017,7137,14100,3657,0.20594695
G81075,7294,5843,5747,5645,3632,1953,6534,760,0.104195229
G81076,10373,8858,8765,8673,6137,5331,7427,2946,0.284006555
G81077,8026,6832,6767,6694,4676,4157,5655,2371,0.295414902
G81082,5983,4733,4643,4545,3242,2496,4789,1194,0.199565435
G81083,7552,5941,5853,5783,4400,2451,6490,1062,0.140625
G81084,11048,9100,8995,8882,6267,5022,8374,2674,0.242034757
G81085,3816,3164,3126,3089,2161,1831,2763,1053,0.275943396
G81086,7872,6492,6407,6316,4640,3396,6423,1449,0.184070122
G81087,6493,5648,5578,5516,3926,3765,4359,2134,0.328661636
G81088,12570,10655,10524,10398,7351,6294,9099,3471,0.276133652
G81089,3492,2763,2731,2701,2030,1217,2989,503,0.144043528
G81090,5636,4997,4968,4927,3211,1725,4945,691,0.122604684
G81095,10165,8778,8682,8586,6261,5123,7610,2555,0.251352681
G81096,3239,2707,2672,2625,1933,1453,2539,700,0.216116085
G81098,10478,8450,8165,7965,5375,4594,7883,2595,0.247661768
G81099,9979,8676,8581,8486,5884,5712,6559,3420,0.342719711
G81100,12651,10278,10145,9999,7139,5114,10083,2568,0.202987906
G81102,14724,12374,12199,12047,8542,7392,10841,3883,0.263719098
G81104,11650,9286,9127,8990,6329,4542,9339,2311,0.198369099
G81105,6079,4885,4821,4759,3378,2364,4935,1144,0.188188847
G81613,5847,4930,4857,4794,3230,1776,5080,767,0.131178382
G81614,5329,4410,4342,4268,3201,2552,4087,1242,0.233064365
G81634,4812,4031,3987,3941,2770,2315,3624,1188,0.246882793
G81638,15368,13687,13613,13538,9439,3107,14375,993,0.064614784
G81641,2924,2339,2311,2276,1663,1097,2447,477,0.163132695
G81646,2529,2034,2014,1984,1626,905,2231,298,0.117833136
G81656,5081,4471,4366,4259,2939,1603,4487,594,0.116906121
G81658,18411,14858,14671,14495,10406,6239,15698,2713,0.147357558
G81663,5755,4850,4777,4711,3502,2304,4782,973,0.169070374
G81667,2039,1780,1760,1742,1265,1127,1421,618,0.30308975
G81669,2598,2072,2033,2006,1518,857,2238,360,0.138568129
G81680,7024,5593,5489,5390,3948,2445,5971,1053,0.149914579
G81689,1524,1481,1478,1472,1234,406,1484,40,0.026246719
G81694,3161,2892,2875,2865,2081,725,2896,265,0.08383423
G82002,8430,6639,6472,6338,4513,3126,6953,1477,0.175207592
G82006,14924,11545,11364,11186,8406,4630,13026,1898,0.1271777
G82007,6188,5377,5310,5249,3563,3365,4309,1879,0.30365223
G82013,13859,11207,10973,10730,7678,5909,10836,3023,0.218125406
G82014,19775,15429,15165,14925,11018,6568,17064,2711,0.137092288
G82015,13318,10678,10524,10366,7286,4658,11159,2159,0.162111428
G82016,10615,8601,8434,8288,5978,4331,8473,2142,0.20178992
G82017,11683,9531,9423,9301,6595,3972,9726,1957,0.167508345
G82018,5185,4605,4557,4506,2971,2967,3381,1804,0.347926712
G82019,12534,10140,10008,9872,7170,5253,9949,2585,0.20623903
G82020,11936,9773,9636,9504,6767,4982,9361,2575,0.215733914
G82021,15935,12667,12450,12268,8527,6053,12941,2994,0.187888296
G82022,8677,6881,6765,6664,4804,3179,7130,1547,0.178287427
G82023,4945,3942,3893,3840,2654,1972,4028,917,0.185439838
G82024,11939,9776,9653,9530,6813,5062,9324,2615,0.21903007
G82025,15014,11975,11779,11608,8623,5116,12736,2278,0.151725057
G82026,7125,5818,5721,5636,4014,2858,5797,1328,0.186385965
G82027,13479,11215,11059,10924,7794,6028,10371,3108,0.230580904
G82028,9545,7730,7626,7530,5257,3840,7483,2062,0.216029335
G82031,12001,9955,9828,9697,7005,4649,9624,2377,0.198066828
G82032,13314,10580,10404,10232,7196,4778,10926,2388,0.179360072
G82035,9637,7920,7837,7725,5423,4054,7435,2202,0.228494345
G82036,12391,10452,10335,10209,7263,6122,9077,3314,0.267452183
G82037,17239,13928,13692,13467,9614,7358,13452,3787,0.219676315
G82038,10033,8494,8398,8317,5816,4998,7298,2735,0.272600419
G82039,18658,15705,15529,15348,10971,7023,15246,3412,0.182870619
G82041,15557,12597,12435,12287,9046,5135,13188,2369,0.152278717
G82042,15753,12755,12566,12382,8995,5867,13031,2722,0.172792484
G82044,22798,17328,17083,16835,12400,5863,20463,2335,0.102421265
G82046,5976,4907,4839,4761,3346,2474,4713,1263,0.211345382
G82048,10235,8277,8164,8021,5728,3725,8458,1777,0.173619932
G82049,3554,2809,2769,2727,1943,1143,2991,563,0.158413056
G82050,21249,16844,16578,16312,11698,6884,18165,3084,0.145136242
G82051,11862,9618,9467,9327,6604,4256,9891,1971,0.16616085
G82052,16753,13328,13133,12949,9158,5859,14006,2747,0.163970632
G82053,4227,3633,3595,3548,2453,2308,2874,1353,0.320085167
G82055,5160,4286,4221,4161,2951,2466,3871,1289,0.249806202
G82056,7406,6013,5911,5831,4173,2934,6044,1362,0.183904942
G82057,10793,8804,8684,8563,6132,4798,8232,2561,0.237283424
G82058,7135,5836,5756,5657,3964,2881,5675,1460,0.204625088
G82059,18730,14990,14657,14344,10321,7302,15155,3575,0.190870262
G82060,20389,16764,16537,16329,10804,6908,16803,3586,0.175879151
G82062,2506,2060,2032,2013,1474,950,2029,477,0.190343176
G82063,12514,10667,10517,10359,7351,6453,9017,3497,0.279447019
G82064,10050,7934,7821,7722,5633,3652,8217,1833,0.18238806
G82066,10109,7935,7821,7681,5208,3780,8093,2016,0.199426254
G82067,9225,7642,7520,7418,5285,3889,7309,1916,0.207696477
G82069,10429,8555,8438,8321,5788,4178,8335,2094,0.200786269
G82071,40482,34037,33619,33203,23824,19696,29955,10527,0.2600415
G82072,3983,3275,3227,3194,2268,1902,2952,1031,0.258850113
G82073,9876,8237,8106,7977,5588,4600,7604,2272,0.230052653
G82074,14147,11590,11441,11292,8249,6511,10522,3625,0.256238072
G82076,10978,8729,8582,8473,5931,4212,8891,2087,0.190107488
G82077,10165,8342,8255,8155,5846,4554,7682,2483,0.244269552
G82079,10651,8951,8860,8766,6084,5052,7792,2859,0.2684255
G82080,32076,24892,24461,24046,16959,9541,27920,4156,0.129567278
G82082,17172,14645,14491,14349,7847,4593,14970,2202,0.128232006
G82083,14252,11376,11221,11066,7911,5610,11415,2837,0.199059781
G82085,12217,9808,9668,9535,6789,4624,9938,2279,0.186543341
G82086,11027,8752,8639,8497,6094,4134,9056,1971,0.178743085
G82087,17603,14231,14026,13791,9832,6652,14259,3344,0.189967619
G82088,6679,5442,5376,5301,3797,2720,5282,1397,0.209163048
G82089,8970,7407,7312,7237,5259,3435,7279,1691,0.18851728
G82090,18654,15805,15612,15392,10640,9305,13284,5370,0.287873914
G82091,9231,7399,7285,7201,5056,3218,7775,1456,0.15772939
G82092,8122,6625,6530,6437,4732,3742,6283,1839,0.226422064
G82093,9434,7895,7803,7717,5614,4599,7050,2384,0.252702989
G82094,10312,8527,8401,8289,6035,4604,8074,2238,0.217028704
G82095,13112,10727,10524,10344,7498,4899,10947,2165,0.165115924
G82097,16200,13420,13248,13066,9171,7596,11929,4271,0.263641975
G82098,7607,6152,6047,5952,4241,3002,6094,1513,0.198895754
G82099,18895,15049,14860,14686,10619,6454,15623,3272,0.173167505
G82100,15639,12657,12470,12277,9058,6316,12507,3132,0.200268559
G82103,3485,2927,2888,2863,2105,1228,2927,558,0.160114778
G82105,19302,15414,15205,15003,10518,7451,15445,3857,0.199823852
G82106,6388,5023,4956,4903,3705,2268,5374,1014,0.158735128
G82107,8563,7230,7144,7062,5120,4297,6210,2353,0.274786874
G82108,5672,4491,4433,4363,3098,2209,4548,1124,0.198166432
G82109,2903,2412,2383,2355,1695,1083,2427,476,0.163968309
G82110,6873,5327,5239,5162,3886,2415,5737,1136,0.165284446
G82111,10787,9253,9172,9071,6404,5793,7529,3258,0.302030222
G82112,8010,6544,6460,6381,4627,3732,6097,1913,0.238826467
G82113,8485,6841,6733,6629,4809,3134,7084,1401,0.165114909
G82114,14514,12387,12248,12104,8159,7939,9856,4658,0.320931514
G82115,10376,8810,8704,8584,5553,3879,8264,2112,0.203546646
G82117,8318,6597,6489,6399,4523,3175,6704,1614,0.194037028
G82118,12558,10265,10123,9967,7189,5229,9885,2673,0.212852365
G82119,22565,18598,18340,18068,12684,9991,17218,5347,0.236959894
G82120,14775,12019,11821,11653,8495,6428,11539,3236,0.219018613
G82121,12914,10855,10747,10599,7640,5937,9682,3232,0.250271024
G82122,20359,15466,15255,15013,11030,5933,17750,2609,0.128149713
G82123,4709,3698,3645,3589,2526,1629,3949,760,0.161393077
G82125,10935,8721,8585,8460,6099,4721,8478,2457,0.224691358
G82126,15809,13091,12914,12748,9225,6901,12270,3539,0.223859827
G82128,6663,5336,5260,5187,3623,2520,5430,1233,0.185051778
G82129,4974,4097,4038,3985,2909,2018,4070,904,0.181745074
G82133,7240,5824,5746,5667,4113,2613,6049,1191,0.164502762
G82135,20858,16153,15911,15681,11976,7420,17556,3302,0.158308563
G82137,8890,6982,6861,6751,4929,3186,7370,1520,0.170978628
G82138,4653,4019,3968,3904,2743,2449,3293,1360,0.292284548
G82139,3459,2806,2764,2715,1946,1333,2859,600,0.173460538
G82140,16887,16430,16402,16368,2526,937,16482,405,0.023982945
G82141,6186,5117,5060,4974,3596,2817,4860,1326,0.214354995
G82142,8941,7291,7176,7081,5186,3888,6983,1958,0.218991164
G82143,6205,5019,4946,4885,3552,2171,5198,1007,0.162288477
G82147,6128,5274,5220,5170,3639,3405,4167,1961,0.320006527
G82150,7658,6025,5933,5853,4149,2648,6441,1217,0.158918778
G82152,6759,5371,5276,5208,3726,2693,5359,1400,0.207131232
G82154,5523,4688,4633,4570,3089,2592,4066,1457,0.263805903
G82155,6203,5157,5073,5000,3511,2832,4702,1501,0.241979687
G82158,4968,4100,4037,3978,2928,2295,3849,1119,0.225241546
G82160,11435,9778,9672,9584,6744,6401,7601,3834,0.335286401
G82161,23114,18509,18227,17993,13350,8580,19191,3923,0.169723977
G82162,4820,4055,4003,3939,2714,2341,3477,1343,0.278630705
G82164,12451,10167,10040,9919,7078,4097,10604,1847,0.148341499
G82165,9615,7817,7680,7577,5477,4135,7486,2129,0.221424857
G82170,2665,2217,2187,2165,1591,1277,2079,586,0.21988743
G82180,4667,3896,3837,3794,2735,2082,3552,1115,0.238911506
G82184,1606,1376,1364,1346,945,783,1207,399,0.248443337
G82185,9056,7317,7203,7117,5215,3334,7473,1583,0.174801237
G82186,7134,5920,5831,5742,4247,3397,5401,1733,0.242921222
G82198,5442,4308,4249,4185,3102,1911,4599,843,0.154906284
G82200,7914,6386,6292,6215,4662,3235,6428,1486,0.187768511
G82203,10381,8045,7910,7783,5633,3424,8847,1534,0.147769964
G82205,9037,6794,6688,6589,5081,2842,7730,1307,0.144627642
G82211,7639,5981,5891,5807,4113,2738,6364,1275,0.166906663
G82212,8083,6113,6022,5951,4502,2010,7322,761,0.094148212
G82215,6726,5482,5408,5340,3914,2813,5378,1348,0.200416295
G82217,3018,2535,2500,2468,1847,1267,2403,615,0.203777336
G82218,5649,4766,4703,4644,3377,2757,4235,1414,0.250309789
G82219,4701,3873,3798,3726,2562,2305,3358,1343,0.285683897
G82221,8232,6373.87521,6303.792091,6229.098241,4696.491094,2399.424667,7287,945,0.114795918
G82224,3787,3054,2982,2914,2127,1634,3094,693,0.182994455
G82225,11045,8765,8618,8504,6072,4244,8993,2052,0.185785423
G82226,4437,3750,3692,3640,2602,2065,3267,1170,0.263691684
G82227,4839,4138,4092,4041,2929,2574,3422,1417,0.292829097
G82228,21711,17823,17367,16864,11286,8431,17283,4428,0.203951914
G82229,6750,5614,5522,5443,3931,2870,5379,1371,0.203111111
G82231,7748,6436,6344,6251,4246,3386,5848,1900,0.245224574
G82232,9207,7518,7437,7332,5291,3607,7515,1692,0.183773216
G82233,11133,8729,8597,8461,6243,3899,9495,1638,0.147130154
G82234,4893,3960,3919,3868,2845,1862,4012,881,0.180053137
G82235,3357,2704,2630,2545,1700,1362,2668,689,0.205242776
G82600,2136,1749,1721,1696,1221,939,1681,455,0.213014981
G82604,14599,11206,11009,10850,7972,4782,12510,2089,0.143091993
G82605,2218,1886,1861,1837,1218,1150,1582,636,0.286744815
G82622,2213,1785,1759,1729,1227,860,1821,392,0.177135111
G82631,7703,5888,5801,5711,4152,2236,6800,903,0.117227054
G82634,10572,8240,8114,7983,5766,3335,8984,1588,0.150208097
G82635,2115,1766,1750,1722,1196,954,1559,556,0.262884161
G82639,3799,3020,2969,2918,2153,1268,3238,561,0.14767044
G82641,4838,3432,3370,3314,2317,1091,4353,485,0.100248036
G82647,17200,12646,12471,12333,9218,4525,15027,2173,0.126337209
G82648,3677,2859,2803,2756,1988,1134,3134,543,0.147674735
G82650,9121,7652,7547,7456,5175,4572,6461,2660,0.291634689
G82652,2567,2160,2139,2114,1539,1289,1840,727,0.283209973
G82653,4044,3162,3114,3074,2201,1258,3497,547,0.135262117
G82658,4914,4082,4033,3980,2990,2380,3751,1163,0.236670737
G82665,4993,4374,4344,4303,3007,3012,3105,1888,0.378129381
G82666,8943,7845,7768,7694,5103,5398,5448,3495,0.390808454
G82671,5635,4199,4113,4040,3160,1552,5066,569,0.100976043
G82679,7073,5658,5562,5460,3982,2369,6033,1040,0.147038032
G82681,5647,4608,4514,4459,3230,2413,4404,1243,0.220116876
G82682,4685,3721,3660,3603,2504,1855,3828,857,0.182924226
G82684,4514,3866,3826,3785,2754,2409,3191,1323,0.29308817
G82687,5141,4168,4133,4072,2886,2157,4083,1058,0.205796538
G82690,3414,2615,2575,2541,1867,1030,2983,431,0.126244874
G82691,3446,2732,2693,2664,1970,1301,2824,622,0.180499129
G82693,16447,12983,12783,12612,9041,6101,13395,3052,0.185565757
G82696,2334,1950,1932,1911,1361,1144,1682,652,0.279348757
G82697,5875,4478,4404,4329,3154,1748,5169,706,0.120170213
G82698,3052,2535,2505,2474,1784,1382,2337,715,0.234272608
G82700,4116,3401,3357,3313,2377,1955,3028,1088,0.264334305
G82702,3333,2588,2556,2525,1822,942,2958,375,0.112511251
G82704,5775,4862,4808,4744,3470,2673,4365,1410,0.244155844
G82706,2503,1888,1852,1826,1300,655,2259,244,0.09748302
G82708,3785,2925,2872,2824,2166,1031,3395,390,0.103038309
G82711,4374,3444,3401,3367,2455,1598,3628,746,0.170553269
G82719,2553,2172,2145,2116,1527,1218,1938,615,0.240893067
G82721,3632,3058,3014,2976,2189,1658,2765,867,0.238711454
G82722,3990,3303,3256,3226,2315,1630,3214,776,0.194486216
G82729,9100,7399,7258,7124,5022,3505,7418,1682,0.184835165
G82730,12101,9491,9271,9093,6693,3931,10586,1515,0.125196265
G82732,4642,3799,3736,3668,2697,2201,3518,1124,0.24213701
G82733,3763,2763,2639,2497,1778,1313,3162,601,0.159712995
G82737,11963,9292,9159,9023,6361,4151,9699,2264,0.189250188
G82741,3300,2597,2563,2526,1882,1134,2879,421,0.127575758
G82744,4404,3619,3572,3530,2301,1565,3631,773,0.175522252
G82753,5720,4338,4233,4117,2946,1632,5123,597,0.104370629
G82754,3578,2947,2898,2832,1918,1538,2817,761,0.212688653
G82757,5091,3834,3774,3719,2695,1357,4623,468,0.09192693
G82760,924,692,678,664,454,142,900,24,0.025974026
G82762,2085,1632,1608,1587,1094,604,1812,273,0.130935252
G82763,2480,1988,1953,1918,1373,848,2105,375,0.151209677
G82768,7021,5531,5466,5403,4096,2293,5952,1069,0.152257513
G82775,2993,2483,2439,2407,1810,1242,2462,531,0.177413966
G82780,12456,9810,9678,9522,6819,3111,11337,1119,0.089836224
G82790,6068,4919,4848,4767,3487,2499,4936,1132,0.186552406
G82791,3292,2572.467876,2542.253148,2512.03842,1819.910352,1135.511633,2961,331,0.10054678
G82796,7380,6213,6130,6073,4384,3546,5431,1949,0.264092141
G82799,10176,8275,8168,8072,5789,4380,7948,2228,0.218946541
G82802,6185,5257,5155,4958,2684,1348,5597,588,0.095068715
G82808,9082,6974,6856,6761,4717,2960,7798,1284,0.141378551
G82809,16374,13569,13345,13170,9258,7397,12436,3938,0.240503237
G82820,5399,4277,4217,4151,2959,1970,4500,899,0.166512317
G82888,6391,4792,4693,4600,3412,1947,5579,812,0.127053669
G83001,12967,10342,10215,10085,7616,4176,11109,1858,0.143286805
G83002,9653,7636,7545,7427,5412,3252,8155,1498,0.155184917
G83003,5172,4118,4047,3979,2848,1684,4405,767,0.148298531
G83004,14663,11926,11756,11608,8213,6139,11369,3294,0.224647071
G83006,15088,12422,12250,12111,8450,6189,11898,3190,0.211426299
G83009,12056,9663,9512,9367,6898,4277,10117,1939,0.16083278
G83010,14138,11310,11122,10953,7750,5087,11864,2274,0.160843118
G83012,16358,12228,11960,11718,9061,4395,15120,1238,0.075681624
G83013,6539,5436,5393,5345,4047,2112,5548,991,0.151552225
G83015,5965,4773,4712,4642,3349,2073,4985,980,0.164291702
G83016,11279,9544,9475,9419,6960,2200,10506,773,0.068534445
G83018,16640,12331,12099,11863,8765,4389,15178,1462,0.087860577
G83019,12248,9816,9687,9548,6964,4317,10435,1813,0.148024167
G83021,16070,12885,12753,12639,9295,3577,14510,1560,0.097075296
G83024,5053,4075,4031,3987,2815,1931,4168,885,0.175143479
G83025,11659,9758,9618,9501,6743,4903,9361,2298,0.197100952
G83026,7880,5866,5760,5670,4172,1733,7341,539,0.068401015
G83027,12985,10400,10263,10135,7398,4171,11235,1750,0.134770889
G83028,12604,10022,9864,9729,7079,4147,10831,1773,0.140669629
G83029,7234,5960,5877,5796,4041,3095,5667,1567,0.21661598
G83030,5771,4422,4365,4291,3200,1606,5147,624,0.108126841
G83031,7734,5941,5836,5740,4181,2442,6765,969,0.125290923
G83033,5295,4509,4449,4389,3142,2376,4034,1261,0.238149197
G83037,4102,3258,3209,3156,2270,1277,3611,491,0.119697708
G83039,8948,6929,6814,6701,4981,2451,8152,796,0.088958426
G83044,11571,8994,8865,8744,6487,2839,10534,1037,0.089620603
G83046,5347,4372,4316,4266,3181,2076,4360,987,0.184589489
G83047,10107,8522,8405,8306,5575,3927,8258,1849,0.182942515
G83049,9633,7884,7785,7695,5490,4005,7420,2213,0.229731133
G83052,16767,12912,12727,12549,9133,5101,14558,2209,0.131746884
G83053,18101,14145,13958,13770,9801,6225,15160,2941,0.162477211
G83057,10091,8467,8347,8224,5838,4357,7948,2143,0.212367456
G83058,9157,7628,7537,7470,5580,2155,8445,712,0.077754723
G83060,6842,5260,5167,5076,3721,1955,6180,662,0.096755335
G83061,7708,6275,6188,6093,4331,2960,6292,1416,0.183705241
G83062,8966,6611,6453,6338,4618,2192,8292,674,0.075172875
G83065,17015,13955,13831,13733,9633,3175,15956,1059,0.062239201
G83066,12500,10055,9921,9773,6546,4714,9867,2633,0.21064
G83067,26056,19714,19366,19075,14193,5560,24510,1546,0.059333743
G83628,9450,7353,7268,7175,5297,2897,8158,1292,0.136719577
G83630,8848,6474,6361,6255,4620,2292,8036,812,0.091772152
G83631,4741,3706,3629,3555,2633,1326,4293,448,0.094494832
G83633,4903,3976,3935,3881,2828,1422,4402,501,0.102182337
G83635,4590,3787,3741,3676,2665,1647,3890,700,0.152505447
G83641,2452,2076,2051,2031,1456,629,2251,201,0.081973899
G83642,9804,7414,7295,7179,5248,2510,8849,955,0.097409221
G83647,6800,5328,5245,5161,3853,1913,6141,659,0.096911765
G83651,6491,5384,5333,5266,3815,1645,5828,663,0.102141427
G83654,5335,4202,4143,4071,3092,1341,4852,483,0.090534208
G83663,1537,1244,1223,1197,830,415,1398,139,0.090435914
G83673,5093,4185,4129,4077,2358,1277,4597,496,0.097388573
G83680,24739,19757,19482,19230,14085,8560,20601,4138,0.16726626
G84001,13419,10879,10740,10609,7927,4747,11261,2158,0.160816752
G84002,12422,10021,9913,9811,7495,3719,10714,1708,0.137497987
G84003,11048,8692,8576,8451,6226,3494,9599,1449,0.13115496
G84004,10391,8767,8654,8536,5950,4969,7692,2699,0.259744009
G84005,5032,4117,4055,4002,2758,2101,3987,1045,0.207670906
G84006,10496,8761,8637,8512,5865,4980,7899,2597,0.247427591
G84007,8800,6937,6829,6726,4806,3218,7395,1405,0.159659091
G84008,5872,4994,4940,4889,3800,2288,4832,1040,0.177111717
G84009,3856,3231,3182,3126,2162,1788,2870,986,0.255705394
G84010,14985,12045,11861,11684,8505,6003,11902,3083,0.205739072
G84011,8808,7093,6975,6863,5125,3204,7450,1358,0.15417802
G84013,3879,3001,2952,2906,1997,1264,3307,572,0.147460686
G84015,11630,9812,9659,9514,6608,5469,8963,2667,0.229320722
G84016,14673,11938,11775,11625,8811,5569,12095,2578,0.175696858
G84017,9358,7766,7649,7514,5288,4159,7344,2014,0.215216927
G84018,8434,7186,7119,7051,5188,3669,6450,1984,0.235238321
G84019,11139,8648,8496,8358,5998,3600,9577,1562,0.140228028
G84020,9586,7752,7638,7525,5495,3993,7584,2002,0.208846234
G84022,4852,4033,3979,3931,2927,1413,4367,485,0.09995878
G84023,11113,8927,8797,8684,6305,4260,9037,2076,0.186808243
G84024,10308,7938,7827,7730,5878,2924,8950,1358,0.131742336
G84025,7648,6080,5995,5925,4620,2049,6998,650,0.08498954
G84027,19051,15200,15014,14845,11545,6369,16329,2722,0.142879639
G84028,6657,5577,5510,5461,3930,2782,5325,1332,0.200090131
G84029,4243,3550,3504,3456,2565,1673,3514,729,0.171812397
G84030,6606,5348,5249,5133,3755,2764,5401,1205,0.18240993
G84032,12293,10058,9923,9796,6914,5240,9465,2828,0.230049622
G84033,7670,6184,6094,6009,4369,2981,6155,1515,0.197522816
G84035,7602,6009,5923,5832,4373,2801,6228,1374,0.18074191
G84039,3313,2610,2571,2516,1914,1156,2777,536,0.1617869
G84040,10712,8298,8206,8084,6114,3320,9120,1592,0.148618372
G84041,3700,2792,2735,2672,1892,945,3336,364,0.098378378
G84604,6078,5031,4983,4923,3604,1973,5194,884,0.14544258
G84607,5460,4445,4371,4292,3052,2158,4423,1037,0.18992674
G84609,3525,2931,2884,2844,2006,1550,2677,848,0.240567376
G84621,3743,2995,2940,2888,2076,1402,3102,641,0.171253006
G84624,2540,2122,2093,2069,1571,796,2236,304,0.119685039
G84625,4696,3715,3661,3608,2791,981,4454,242,0.05153322
G84627,7328,5984,5904,5816,4256,3157,5732,1596,0.21779476
G84629,5748,4515,4438,4378,3359,1615,5120,628,0.109255393
G84630,3156,2523,2479,2443,1830,998,2700,456,0.144486692
G85001,11862,9478,9373,9249,7113,3902,10261,1601,0.134968808
G85002,19525,15996,15836,15696,10930,2427,18815,710,0.036363636
G85003,6873,5848,5779,5729,4298,2056,6023,850,0.123672341
G85004,15022,12162,12015,11913,9135,4331,13298,1724,0.114765011
G85005,16227,13117,12914,12692,9110,5722,13918,2309,0.142293708
G85006,9065,7170,7050,6945,5299,2695,8283,782,0.086265858
G85008,3775,3175,3133,3095,2376,1406,3276,499,0.13218543
G85011,21793,19439,19327,19215,12455,3779,20631,1162,0.053319873
G85013,10153,8605,8517,8425,6286,3048,9146,1007,0.099182508
G85014,11289,9138,9030,8944,6692,3295,9959,1330,0.117813801
G85015,9186,7743,7655,7565,5573,2987,8114,1072,0.116699325
G85016,15772,13126,12967,12805,9545,4513,14213,1559,0.098846056
G85019,4362,3549,3493,3440,2558,1144,4061,301,0.069005044
G85020,6694,5830,5776,5668,3377,1405,6243,451,0.067373768
G85021,5245,4515,4469,4421,3139,1966,4317,928,0.17693041
G85022,16987,13918,13678,13466,9849,5338,15026,1961,0.11544122
G85023,11590,9702,9618,9543,6856,2461,10720,870,0.075064711
G85024,16963,13555,13377,13179,9930,5235,14933,2030,0.119672228
G85025,11252,9810,9737,9649,6764,2489,10561,691,0.061411305
G85026,4578,3748,3697,3643,2532,1574,3984,594,0.129750983
G85027,5995,4860,4785,4718,3495,2267,4956,1039,0.173311093
G85028,12352,10597,10470,10341,7164,3771,11002,1350,0.109294041
G85029,9702,8450,8370,8308,5013,2085,9062,640,0.06596578
G85030,6500,5411,5355,5286,3802,1671,5980,520,0.08
G85031,6741,5544,5488,5442,4195,1884,6072,669,0.099243436
G85032,11936,9581,9431,9246,6781,3868,10499,1437,0.120392091
G85034,77809,65268,64576,63834,46130,19834,71376,6433,0.082676811
G85035,9197,7683,7598,7515,5463,2359,8356,841,0.091442862
G85038,14486,11924,11803,11687,8632,3364,13399,1087,0.075037968
G85039,20004,15818,15601,15390,11734,5931,17539,2465,0.123225355
G85040,9976,8730,8666,8597,5281,1823,9355,621,0.062249399
G85041,7810,6561,6494,6406,4830,2499,6971,839,0.107426376
G85042,5125,4188,4130,4073,2857,1337,4675,450,0.087804878
G85044,5688,4728,4674,4624,3475,1776,4993,695,0.12218706
G85045,8678,7606,7540,7459,5222,2435,7761,917,0.105669509
G85046,11783,9520,9438,9346,7236,3649,10141,1642,0.139353306
G85047,9656,7840,7761,7687,5706,1941,9004,652,0.067522784
G85051,8357,6559,6457,6356,4784,2867,7265,1092,0.1306689
G85052,10457,8561,8465,8375,5881,1980,10062,395,0.03777374
G85053,26310,23507,23353,23211,16080,5298,24703,1607,0.061079437
G85054,8999,7682,7594,7526,5341,2869,7784,1215,0.135015002
G85055,17316,13898,13741,13588,10300,4740,15489,1827,0.105509356
G85057,6711,4937,4813,4701,3434,1615,6207,504,0.075100581
G85061,7590,6181,6097,6040,4509,2485,6652,938,0.123583663
G85073,8040,7092,7032,6973,4890,1944,7428,612,0.076119403
G85076,12627,10412,10278,10154,7051,2516,11973,654,0.051793775
G85083,13089,11756,11683,11572,7794,3146,12204,885,0.067614027
G85084,11003,9608,9550,9485,5768,1801,10380,623,0.056620922
G85085,11516,9727,9631,9542,6558,2041,10948,568,0.049322681
G85086,8149,7137,7060,6986,5110,2131,7452,697,0.085531967
G85087,12608,10641,10526,10427,6806,2101,11971,637,0.050523477
G85089,10454,8242,8132,8043,6028,2386,9785,669,0.063994643
G85091,5485,4355,4331,4300,3300,988,5120,365,0.066545123
G85096,9920,8207,8095,7999,5959,2547,9065,855,0.086189516
G85100,7710,6882,6828,6763,4516,1832,7219,491,0.063683528
G85102,4300,3820,3785,3747,2243,1013,3945,355,0.08255814
G85104,10526,8364,8227,8085,5768,3470,9146,1380,0.131103933
G85105,7189,6072,6024,5981,4245,1467,6733,456,0.063430241
G85106,1018,889.4996221,882.1897203,874.8798186,592.8715042,245.8435374,993,25,0.024557957
G85109,18134,15618,15468,15337,9647,3438,16980,1154,0.063637366
G85114,12011,9335,9198,9055,6768,3253,10840,1171,0.097493964
G85118,5974,5114,5061,4993,3087,1254,5596,378,0.063274188
G85119,5885,5000,4948,4900,3438,1384,5356,529,0.08988955
G85120,7422,6062,6013,5941,4483,2191,6694,728,0.098086769
G85121,5767,4661,4590,4540,3230,1445,5236,531,0.092075603
G85123,7838,6697,6616,6543,4702,2033,7197,641,0.081781067
G85124,7497,5796,5691,5597,4099,2125,6799,698,0.093103908
G85125,6092,4861,4789,4725,3316,1629,5486,606,0.099474721
G85127,6243,5360,5292,5237,3831,1376,5923,320,0.051257408
G85129,4502,3644,3599,3557,2689,1169,4171,331,0.073522879
G85130,10406,8921,8833,8729,5940,2442,9618,788,0.075725543
G85132,13113,10915,10800,10695,7681,2824,12226,887,0.067642797
G85134,5459,4355,4286,4206,3115,1577,5026,433,0.079318557
G85135,11987,9876,9711,9566,6986,3486,11031,956,0.079753066
G85136,12512,11444,11358,11226,7098,2283,11765,747,0.059702685
G85137,9623,7813,7747,7693,5821,1723,9075,548,0.056946898
G85138,15523,13493,13395,13313,9455,3069,14492,1031,0.066417574
G85623,11415,9478,9370,9260,6711,2476,10571,844,0.073937801
G85632,8075,6667,6590,6532,4567,1609,7627,448,0.055479876
G85633,21534,16928,16693,16489,12249,5549,19638,1896,0.08804681
G85642,8566,7823,7786,7747,4263,1632,7979,587,0.068526734
G85644,7023,5653,5599,5542,4317,1805,6425,598,0.085148797
G85647,7085,5597,5531,5445,4227,1556,6573,512,0.072265349
G85651,8984,6880,6783,6717,5432,2131,8348,636,0.07079252
G85662,7336,6302,6230,6154,4549,2324,6469,867,0.118184297
G85673,6897,5645,5552,5475,3913,1432,6511,386,0.055966362
G85674,6047,5299,5279,5258,3661,825,5774,273,0.045146354
G85681,5395,4452,4405,4363,3128,1340,4943,452,0.083781279
G85685,9430,7562,7465,7395,5489,2461,8502,928,0.098409332
G85690,7271,6006,5940,5865,3994,1496,6856,415,0.057076056
G85695,5598,4793,4742,4693,3204,1062,5365,233,0.041622008
G85696,14131,11177,11071,10956,8553,2785,13204,927,0.065600453
G85698,14004,12243,12153,12075,6573,2088,13433,571,0.040774065
G85705,6723,6161,6138,6122,4412,1359,6336,387,0.057563588
G85706,6307,4994,4919,4831,3562,1753,5619,688,0.109085143
G85708,10807,9471,9407,9347,6129,1997,10164,643,0.059498473
G85711,7501,6651,6621,6582,4110,889,7243,258,0.034395414
G85715,11002,8930,8830,8696,6298,2557,10387,615,0.055898927
G85716,5417,4091,4026,3944,2898,1290,5031,386,0.071257153
G85721,7868,6643,6560,6488,4935,2032,7327,541,0.068759532
G85722,9292,7353,7265,7183,5510,1824,8759,533,0.057361171
G85724,16035,13746,13636,13532,9589,2075,15557,478,0.029809791
G85726,7710,6381,6301,6225,4227,1880,7135,575,0.07457847
G85727,6543,4910,4848,4782,3772,1488,6024,519,0.079321412
G85736,3492,2869,2821,2786,2018,791,3223,269,0.077033219
H81002,8450,6943,6866,6787,5091,2725,7250,1200,0.142011834
H81003,19010,15330,15092,14885,10764,7307,15436,3574,0.188006312
H81004,12854,10802,10666,10533,7444,6116,9628,3226,0.25097246
H81005,7327,5972,5890,5822,4181,3158,5734,1593,0.21741504
H81006,7885,6539,6444,6355,4591,3113,6389,1496,0.18972733
H81007,11297,9100,8969,8798,6666,4403,9408,1889,0.167212534
H81009,16441,13432,13252,13098,9413,6504,13334,3107,0.188978773
H81010,21299,18406,18248,18113,9264,5105,18956,2343,0.110005165
H81011,8159,6501,6396,6290,4583,3114,6608,1551,0.190096826
H81013,27675,22512,22228,21966,16192,10923,22271,5404,0.195266486
H81015,11571,9330,9157,8980,6528,4784,9344,2227,0.192463918
H81016,10363,8794,8642,8527,5773,5316,7455,2908,0.280613722
H81017,20301,16602,16343,16105,11534,8302,16140,4161,0.204965273
H81019,11518,9367,9240,9113,6695,4282,9574,1944,0.168779302
H81020,11188,8456,8337,8235,6409,3793,9452,1736,0.15516625
H81021,15924,12638,12293,11955,8781,5727,12943,2981,0.187201708
H81022,4737,3840,3801,3749,2789,2143,3647,1090,0.230103441
H81023,10630,8703,8577,8446,6151,4641,8363,2267,0.213264346
H81024,12376,9919,9792,9664,7090,4477,10320,2056,0.16612799
H81025,11581,9656,9526,9383,6772,5101,8942,2639,0.227873241
H81026,10870,8916,8819,8705,6362,4360,8802,2068,0.19024839
H81027,10649,8936,8814,8731,5425,3991,8567,2082,0.195511316
H81028,11172,9607,9483,9356,6640,5602,8276,2896,0.259219477
H81029,12044,10184,10072,9968,6985,3745,10325,1719,0.142726669
H81030,14793,12030,11873,11738,8675,4798,12583,2210,0.149394984
H81031,10911,8758,8587,8413,6115,4195,9002,1909,0.174961048
H81032,19328,14992,14777,14570,11192,5866,16751,2577,0.133329884
H81033,20733,16931,16759,16563,11971,7717,17112,3621,0.17464911
H81034,8581,7064,6960,6868,4976,3598,6782,1799,0.209649225
H81035,12202,9687,9516,9351,6994,4466,10207,1995,0.163497787
H81036,10093,8347,8209,8088,5806,4285,7882,2211,0.219062717
H81037,17208,13719,13581,13448,10045,6065,14165,3043,0.176836355
H81038,4195,3426,3357,3291,2377,1731,3381,814,0.194040524
H81039,6867,5638,5570,5505,4105,2719,5573,1294,0.188437454
H81040,7859,6469,6378,6308,4461,3028,6342,1517,0.193027103
H81041,10723,8525,8404,8312,6221,3272,9241,1482,0.138207591
H81042,16851,13651,13471,13294,9670,6057,14107,2744,0.162839001
H81043,10572,8678,8537,8403,6008,4807,8174,2398,0.226825577
H81044,4247,3536,3495,3456,2422,2143,3129,1118,0.263244643
H81045,9903,8019,7905,7768,5691,3697,8109,1794,0.181157225
H81046,5441,4416,4363,4324,3155,2006,4408,1033,0.189854806
H81047,12165,10027,9891,9767,6934,4873,9787,2378,0.195478833
H81048,9983,7522,7348,7195,5505,2688,8927,1056,0.105779826
H81050,11250,9052,8921,8822,6414,4396,8928,2322,0.2064
H81051,14552,11753,11606,11463,7661,4651,12179,2373,0.163070368
H81052,16349,13682,13390,13068,8635,7241,12164,4185,0.255978959
H81053,8024,6576,6486,6387,4698,3601,6245,1779,0.22170987
H81055,8704,7156,7060,6972,4933,3573,6919,1785,0.205078125
H81056,16704,13476,13255,13050,9364,7094,13124,3580,0.214319923
H81057,6862,5641,5563,5491,3850,2700,5633,1229,0.179102303
H81058,10166,8215,8082,7973,6105,3445,8659,1507,0.148239229
H81060,12525,10042,9857,9671,6975,4990,10025,2500,0.199600798
H81061,14749,11990,11881,11757,8686,4292,12937,1812,0.122855787
H81062,18991,15284,15031,14836,10919,8105,14965,4026,0.211995156
H81064,13142,10684,10556,10412,7571,5540,10344,2798,0.212905189
H81065,8664,6848,6761,6671,4777,3326,6787,1877,0.216643583
H81066,15745,12915,12688,12463,9092,5358,13461,2284,0.145061924
H81067,13345,10714,10473,10254,7164,5272,10785,2560,0.191832147
H81068,12280,10373,10226,10079,7232,5918,9310,2970,0.241856678
H81069,21295,17388,17131,16891,11984,8138,17267,4028,0.189152383
H81070,11793,9824,9679,9548,6871,5479,9170,2623,0.22242008
H81071,10001,8120,7984,7877,5873,3366,8489,1512,0.151184882
H81072,12098,9778,9638,9484,7111,4372,10106,1992,0.164655315
H81073,14203,11277,11098,10968,8314,5128,11840,2363,0.166373301
H81074,5969,4774,4708,4647,3472,2557,4607,1362,0.228178924
H81075,11551,9587,9433,9317,6665,4518,9457,2094,0.181283006
H81076,12117,10268,10121,9975,7047,6141,8842,3275,0.270281423
H81077,8021,6551,6381,6196,4522,3685,6285,1736,0.216431866
H81078,21250,16820,16573,16328,12284,7677,17753,3497,0.164564706
H81080,10911,9204,9064,8944,6176,5423,8025,2886,0.264503712
H81081,9520,7733,7630,7519,5201,3989,7341,2179,0.228886555
H81082,10195,8438,8331,8216,5883,3794,8495,1700,0.166748406
H81083,11776,9355,9212,9075,6794,3995,10077,1699,0.144276495
H81084,10400,8598,8434,8288,5791,4882,7943,2457,0.23625
H81085,10958,8913,8764,8637,6297,3884,9163,1795,0.163807264
H81086,5246,4245,4196,4142,3130,2045,4272,974,0.185665269
H81087,14113,10930,10786,10643,7964,3964,12447,1666,0.118047191
H81088,12578,10432,10301,10176,7210,5167,9904,2674,0.212593417
H81089,20693,15888,15627,15399,11630,6837,17642,3051,0.147441164
H81090,14761,12647,12545,12419,6749,3501,13315,1446,0.097960843
H81091,6779,5488,5410,5346,3845,2778,5374,1405,0.207257708
H81094,9787,7837,7712,7613,5619,3521,8185,1602,0.163686523
H81095,4790,3875,3822,3788,2725,1803,3909,881,0.183924843
H81097,7082,5763,5679,5610,4153,2966,5632,1450,0.204744422
H81099,11349,8886,8718,8562,6454,4049,9702,1647,0.145122918
H81103,7992,6570,6460,6368,4510,3696,6023,1969,0.246371371
H81104,8678,7078,6996,6885,5078,2954,7488,1190,0.137128371
H81107,7737,5950,5821,5694,4168,2946,6476,1261,0.162983068
H81109,7983,6287,6173,6059,4478,3244,6461,1522,0.190655142
H81110,6169,5040,4946,4854,3430,2659,4902,1267,0.205381747
H81111,5039,4104,4051,3986,2888,2175,3984,1055,0.209366938
H81113,7967,6837,6729,6658,4813,3943,5994,1973,0.247646542
H81116,6046,4954,4884,4819,3453,2668,4615,1431,0.236685412
H81119,19228,15524,15325,15111,11182,7147,16122,3106,0.161535261
H81122,7349,6002,5937,5864,4346,2751,6041,1308,0.177983399
H81123,2877,2120,2082,2031,1478,713,2600,277,0.096280848
H81126,7121,5753,5671,5580,4033,3000,5666,1455,0.204325235
H81128,6359,5178,5119,5049,3780,2669,5131,1228,0.193112125
H81129,4082,3227,3180,3135,2338,1404,3477,605,0.148211661
H81130,12766,10476,10325,10179,7462,5306,10335,2431,0.190427699
H81131,3612,2949,2903,2863,2139,1297,3053,559,0.154761905
H81132,2855,2478,2451,2423,1834,1216,2311,544,0.190542907
H81133,32932,26582,26149,25691,18928,12784,26826,6106,0.185412365
H81134,12558,10449,10306,10185,7404,4955,10175,2383,0.189759516
H81613,4489,3394,3358,3316,2543,1312,3893,596,0.132768991
H81615,12556,9677,9487,9311,7001,4783,10357,2199,0.175135393
H81618,5459,4581,4510,4459,3063,2129,4388,1071,0.196189778
H81632,2555,2144,2120,2102,1519,1144,1993,562,0.219960861
H81638,7199,5898,5813,5738,4212,2903,5899,1300,0.180580636
H81641,3235,2493,2438,2387,1686,602,2994,241,0.074497682
H81642,3577,2910,2874,2839,2080,1360,2939,638,0.178361756
H81643,3195,2489,2454,2413,1701,572,3007,188,0.058841941
H81644,9317,7569,7456,7345,5143,3555,7585,1732,0.185896748
H81656,7573,6223,6150,6066,4394,3311,5858,1715,0.226462432
H81658,5488,4574,4527,4458,3253,2483,4267,1221,0.222485423
H81663,3923,3077,3032,3004,2187,1098,3412,511,0.130257456
H81672,5809,4476,4408,4341,3188,2093,4765,1044,0.179721122
H82003,9426,7854,7732,7601,5543,3908,7607,1819,0.192976872
H82004,4692,3953,3909,3863,2878,2289,3619,1073,0.228687127
H82005,11928,9353,9139,8946,6616,3892,10200,1728,0.144869215
H82006,6062,5213,5156,5102,3490,3254,4219,1843,0.304025074
H82007,13074,11183,11076,10953,7500,6878,8932,4142,0.316811993
H82008,11012,9102,8989,8853,6367,4957,8426,2586,0.234834726
H82009,15482,12576,12407,12250,8903,6495,12245,3237,0.209081514
H82010,7116,6017,5943,5886,4325,3492,5325,1791,0.251686341
H82011,14837,12230,12075,11912,8328,6133,11656,3181,0.214396441
H82012,11502,9040,8907,8779,6406,3198,10102,1400,0.121717962
H82013,11927,10259,10167,10076,6987,5803,8681,3246,0.272155613
H82014,12547,10561,10414,10284,7038,6201,8806,3741,0.298158922
H82015,6211,5372,5323,5278,3562,3413,4043,2168,0.349058123
H82016,13549,11279,11176,11071,7713,5101,10944,2605,0.192265112
H82017,23953,19393,19046,18679,13145,9314,19214,4739,0.197845781
H82020,9050,7887,7833,7777,5593,3462,7423,1627,0.179779006
H82021,6546,5699,5621,5559,3978,3690,4459,2087,0.318820654
H82022,12165,10134,9975,9799,6932,5958,8889,3276,0.269297164
H82023,14653,12037,11860,11672,8393,6325,11212,3441,0.234832458
H82025,15614,12612,12416,12243,8980,5723,13252,2362,0.151274497
H82026,17577,13657,13448,13242,10203,4627,15948,1629,0.092677931
H82027,3760,3145,3112,3073,2277,1811,2883,877,0.233244681
H82028,11903,9670,9567,9452,7024,4124,9941,1962,0.164832395
H82029,10467,8472,8357,8232,5888,4154,8308,2159,0.206267316
H82030,12969,11123,11004,10891,7765,7041,8949,4020,0.309969928
H82031,6012,5013,4946,4889,3614,2988,4528,1484,0.246839654
H82032,12578,10653,10547,10422,7290,6359,9044,3534,0.280966767
H82033,7509,6006,5926,5846,4174,2442,6454,1055,0.140498069
H82034,21364,17806,17575,17356,12336,9966,15939,5425,0.253931848
H82035,11588,9530,9396,9288,6601,5379,8605,2983,0.25742147
H82036,9272,7907,7822,7731,5402,4520,6664,2608,0.281276963
H82037,12510,10886,10768,10657,7203,6974,8241,4269,0.341247002
H82038,13351,11162,11014,10884,7374,6650,9342,4009,0.300277133
H82039,10768,8854,8749,8640,6094,4558,8310,2458,0.228268945
H82040,8332,6790,6702,6608,5022,3685,6449,1883,0.225996159
H82041,13874,11425,11271,11161,8025,5269,11331,2543,0.18329249
H82042,14003,11990,11872,11734,7359,5483,11167,2836,0.20252803
H82043,11690,10368,10288,10213,6684,7240,6874,4816,0.411976048
H82044,11344,9195,9055,8928,6637,4612,9110,2234,0.196932299
H82045,20757,17544,17363,17205,11836,8367,16252,4505,0.217035217
H82046,12447,10178,10035,9894,7228,4931,10127,2320,0.186390295
H82047,10733,8758,8658,8556,6267,3748,8955,1778,0.165657319
H82048,10767,9267,9178,9104,6406,5767,7474,3293,0.305841924
H82049,10446,8952,8832,8722,5654,4567,7899,2547,0.243825388
H82050,10223,8101,8003,7912,5797,3286,8728,1495,0.146238873
H82051,12143,10378,10272,10160,6328,5337,9074,3069,0.252738203
H82052,15945,13042,12866,12700,9260,6187,12974,2971,0.186328003
H82053,7314,6135,6066,5993,4200,2958,5852,1462,0.199890621
H82055,13359,10858,10673,10526,7657,5718,10632,2727,0.204132046
H82056,12757,10338,10139,9966,7203,4895,10054,2703,0.211883672
H82057,20123,16250,16008,15783,11491,8954,15418,4705,0.233812056
H82058,15362,12603,12440,12291,8490,6087,12278,3084,0.20075511
H82059,10746,9309,9219,9131,6048,5949,6948,3798,0.353433836
H82060,10025,8428,8333,8222,5823,5083,7321,2704,0.269725686
H82061,8525,7146,7073,6979,5124,3332,6980,1545,0.181231672
H82063,15240,12440,12277,12111,8702,6169,12091,3149,0.206627297
H82064,10100,7843,7714,7616,5534,2767,8897,1203,0.119108911
H82065,14267,11883,11742,11595,8162,6512,10620,3647,0.255624869
H82066,16082,13200,13028,12867,9183,6620,12710,3372,0.209675414
H82067,5927,4664,4607,4557,3348,2050,4945,982,0.16568247
H82070,12421,10544,10438,10324,7270,6673,8573,3848,0.309797923
H82072,12992,10683,10549,10415,7461,5141,10467,2525,0.194350369
H82076,3455,2963,2919,2886,2017,1898,2363,1092,0.316063676
H82077,11593,9593,9465,9318,6705,5299,8860,2733,0.235745709
H82078,10732,8768,8664,8565,6117,5065,8004,2728,0.254193067
H82083,11283,9092,8995,8877,6459,4584,8950,2333,0.206771249
H82084,6552,5439,5376,5303,3662,2608,5165,1387,0.211691087
H82087,4114,3784,3751,3731,2367,2979,2076,2038,0.495381624
H82088,7150,5522,5429,5345,4093,1781,6645,505,0.070629371
H82089,8249,6748,6648,6552,4911,3279,6859,1390,0.168505273
H82091,7943,6711,6652,6590,4627,3677,5952,1991,0.250660959
H82092,9185,7339,7231,7099,5345,3396,7811,1374,0.149591726
H82095,10388,8859,8773,8697,5900,5732,6892,3496,0.336542164
H82096,6517,5421,5363,5310,3748,2813,4991,1526,0.234156821
H82098,11002,8728,8594,8482,6125,2843,9938,1064,0.096709689
H82099,7565,6507,6432,6362,4338,3843,5273,2292,0.302974223
H82100,7967,6201,6119,6050,4525,2699,6570,1397,0.175348312
H82615,7750,6207,6120,6027,4489,3036,6416,1334,0.172129032
H82621,5555,4325,4262,4186,3063,1971,4573,982,0.176777678
H82640,15994,12983,12760,12528,9363,6403,13391,2603,0.162748531
H83001,12128,9732,9586,9435,6980,3785,10813,1315,0.108426781
H83004,11540,9580,9462,9355,6760,4879,8931,2609,0.226083189
H83005,14193,11497,11352,11216,8837,3292,13151,1042,0.073416473
H83006,10809,8069,7893,7726,5301,2797,9754,1055,0.097603849
H83007,11187,8579,8437,8304,6019,3213,9923,1264,0.11298829
H83008,3454,2876,2833,2800,1910,1306,2881,573,0.165894615
H83009,10752,8777,8662,8541,6057,3227,9378,1374,0.127790179
H83010,7136,5876,5784,5703,4100,2331,6221,915,0.128223094
H83011,5971,4795,4747,4680,3480,1559,5447,524,0.087757495
H83012,10268,7845,7717,7586,5594,2645,9328,940,0.091546552
H83013,15852,12573,12401,12234,8991,5956,12915,2937,0.185276306
H83014,7201,6053,5989,5904,4151,3106,5541,1660,0.230523538
H83015,13695,10878,10743,10595,7922,4487,11731,1964,0.143410004
H83016,16305,13199,13004,12830,9389,5758,13552,2753,0.168843913
H83017,15351,12258,12049,11806,8623,4835,13768,1583,0.103120318
H83018,12111,9899,9742,9598,6870,4693,9938,2173,0.179423664
H83019,7841,6507,6418,6328,4709,2506,6791,1050,0.133911491
H83020,11095,8743,8583,8442,6183,3275,9876,1219,0.109869311
H83021,5985,4881,4800,4714,3337,1930,5197,788,0.13166249
H83022,6941,5572,5493,5400,3854,2302,6078,863,0.12433367
H83023,7031,5647,5571,5504,4132,2269,6142,889,0.126440051
H83024,17098,13904,13718,13520,9899,6484,14109,2989,0.174815768
H83027,5677,4547,4472,4375,3049,1976,4850,827,0.145675533
H83028,3764,2899,2842,2788,1881,1256,3227,537,0.142667375
H83029,4427,3753,3709,3662,2527,2102,3300,1127,0.254574204
H83030,3213,2410,2357,2288,1597,934,2839,374,0.116402116
H83031,3573,2937,2906,2880,2104,1210,2998,575,0.160929191
H83033,3689,2833,2785,2745,2046,963,3328,361,0.097858498
H83034,7302,5725,5634,5531,4076,2068,6570,732,0.100246508
H83037,7316,6071,6025,5976,4727,2125,6430,886,0.121104429
H83039,7775,6437,6358,6301,4693,2771,6591,1184,0.152282958
H83040,4084,3353,3313,3268,2436,1668,3238,846,0.207149853
H83042,7596,6027,5925,5831,4045,2335,6641,955,0.125724065
H83043,7771,6587,6469,6365,4499,3526,6052,1719,0.221207052
H83044,20259,16540,16367,16163,12080,4675,18242,2017,0.099560689
H83049,2630,1994,1950,1909,1345,757,2383,247,0.09391635
H83050,6118,4845,4781,4716,3527,2213,5103,1015,0.16590389
H83051,12875,10049,9906,9782,7046,2415,12222,653,0.050718447
H83052,2876,2339,2312,2286,1701,1189,2279,597,0.207579972
H83053,15366,12379,12178,11991,8678,4867,13632,1734,0.112846544
H83608,5360,4221,4157,4094,2937,1315,4920,440,0.082089552
H83609,4255,3443,3388,3343,2395,1309,3715,540,0.126909518
H83611,4362,3352,3310,3273,2452,896,4067,295,0.067629528
H83624,8143,6681,6594,6525,4843,2214,7317,826,0.101436817
H83625,3710,3091,3047,2995,2214,1231,3273,437,0.117789757
H83627,6789,5499,5430,5344,4030,1870,6025,764,0.112534983
H83631,9391,7154,7030,6927,5143,2015,8803,588,0.06261314
H84002,12939,10362,10209,10082,7921,4770,10957,1982,0.153180308
H84005,14987,12536,12378,12238,9420,4987,13077,1910,0.127443785
H84006,17844,14261,14066,13915,10414,6075,14984,2860,0.160277965
H84007,8617,7139,7070,6983,5351,3122,7274,1343,0.155854706
H84010,10077,8063,7939,7841,5979,3466,8612,1465,0.14538057
H84012,12681,10570,10457,10349,7028,3568,10999,1682,0.132639382
H84014,2877,2395,2373,2343,1904,999,2464,413,0.143552311
H84015,8277,6600,6533,6459,4973,2466,7275,1002,0.121058354
H84016,15976,12929,12673,12447,9052,5738,13365,2611,0.163432649
H84017,13930,11294,11127,10967,7765,5011,11602,2328,0.167121321
H84018,5660,4563,4511,4455,3346,2067,4659,1001,0.176855124
H84020,24154,21276,21082,20938,9684,4033,22524,1630,0.067483647
H84023,10349,8211,8074,7964,6177,3320,9148,1201,0.11604986
H84025,7470,5837,5762,5683,4198,2278,6484,986,0.131994645
H84027,19394,15158,14960,14773,11313,5150,17310,2084,0.107455914
H84030,14704,12134,11962,11820,8737,5501,11984,2720,0.184983678
H84031,5995,4643,4578,4500,3324,2084,4987,1008,0.168140117
H84032,9806,8064,7963,7846,6139,3668,8236,1570,0.160106058
H84033,6901,5521,5432,5323,4009,2792,5662,1239,0.179539197
H84034,8653,7071,6968,6853,4954,3095,7234,1419,0.163989368
H84039,11089,8971,8821,8709,6837,3993,9404,1685,0.151952385
H84040,12077,9864,9718,9585,7182,4944,9650,2427,0.200960503
H84041,5692,4454,4416,4381,3531,1290,5225,467,0.082044975
H84042,12832,10360,10222,10095,7453,4270,10906,1926,0.150093516
H84044,8929,6846,6726,6626,5168,2671,7861,1068,0.119610259
H84048,8157,6395,6313,6220,4971,2437,7202,955,0.117077357
H84050,7378,5906,5818,5735,4164,2575,6214,1164,0.157766332
H84051,6105,4982,4883,4797,3521,1904,5370,735,0.12039312
H84053,4606,3795,3759,3714,2725,1614,3783,823,0.178679983
H84054,3243,2681,2647,2609,1840,1013,2790,453,0.139685476
H84055,11907,9396,9275,9139,7092,3871,10211,1696,0.142437222
H84057,3438,2681,2638,2612,2015,939,3079,359,0.104421175
H84059,4465,3577,3525,3465,2577,1570,3868,597,0.133706607
H84060,7533,5776,5693,5617,4578,2352,6566,967,0.128368512
H84061,15630,12569,12405,12252,8738,3014,14648,982,0.062827895
H84062,8015,6549,6468,6407,4792,2746,6824,1191,0.148596382
H84618,4962,3880,3809,3746,2805,1410,4429,533,0.107416364
H84619,11209,9060,8974,8916,7162,2544,10328,881,0.078597556
H84623,8620,6852,6736,6623,5093,2978,7415,1205,0.139791183
H84625,4400,3556,3486,3431,2531,1477,3775,625,0.142045455
H84629,5568,4626,4564,4505,3296,1623,4942,626,0.112428161
H84630,3745,2840,2810,2769,2055,902,3419,326,0.087049399
H84635,14583,11574,11431,11289,8545,4811,12320,2263,0.15518069
H84639,5551,4330,4276,4224,3391,1270,5148,403,0.072599532
H85001,18489,16039,15932,15856,11332,2522,17580,909,0.049164368
H85002,9642,8139,8050,7955,5463,2254,8785,857,0.088881975
H85003,7708,6711,6667,6610,4711,2106,6881,827,0.107291126
H85005,8845,7585,7492,7396,5553,3483,7374,1471,0.166308649
H85006,6799,5487,5408,5337,3718,1840,5943,856,0.125900868
H85007,12282,9820,9687,9587,7244,3791,10555,1727,0.140612278
H85008,6049,5015,4953,4879,3299,2108,5030,1019,0.168457596
H85009,13733,11745,11662,11589,7827,2765,12700,1033,0.075220272
H85011,9629,7762,7658,7558,5488,2699,8563,1066,0.110707239
H85012,26934,23294,23128,22964,15435,5541,24739,2195,0.081495508
H85018,9127,7340,7261,7187,5462,2976,7700,1427,0.156349293
H85020,29801,24170,23883,23645,17697,8591,25894,3907,0.131102983
H85021,6300,5218,5131,5047,3615,2297,5375,925,0.146825397
H85022,4223,3351,3298,3257,2506,1387,3580,643,0.152261426
H85023,4666,3697,3647,3586,2582,1521,3992,674,0.144449207
H85024,8793,7450,7368,7298,5107,2792,7636,1157,0.13158194
H85025,15490,12211,12054,11915,8921,4955,13267,2223,0.143511943
H85026,14408,11511,11358,11257,8718,3497,13099,1309,0.090852304
H85027,13005,10803,10670,10547,7749,4959,10591,2414,0.185620915
H85028,9723,7844,7756,7694,5927,2500,8628,1095,0.112619562
H85029,10128,7780,7629,7470,5257,2740,9071,1057,0.104364139
H85030,12869,10564,10445,10315,7551,4743,10594,2275,0.176781413
H85031,11378,9100,8996,8884,6602,3776,9648,1730,0.152047812
H85032,3710,2925,2877,2843,2115,1350,3023,687,0.185175202
H85033,9028,7327,7216,7099,5074,3052,7818,1210,0.13402747
H85035,6985,5772,5673,5594,4072,2433,5951,1034,0.148031496
H85037,15001,12497,12316,12186,8725,4564,12985,2016,0.134391041
H85038,11559,9034,8921,8813,6396,3351,10123,1436,0.1242322
H85041,12924,10539,10456,10389,7564,2742,11825,1099,0.085035593
H85045,14603,12218,12117,12022,8883,4271,12806,1797,0.123056906
H85047,10928,9319,9235,9161,6868,3168,9713,1215,0.111182284
H85048,17084,13661,13502,13351,9886,3970,15632,1452,0.084991805
H85049,7627,6114,6042,5997,4440,1562,7098,529,0.069358857
H85051,18403,14572,14395,14193,11017,4873,16407,1996,0.108460577
H85052,4877,4095,4038,3987,2710,1539,4162,715,0.14660652
H85053,4580,3688,3649,3605,2669,1380,3996,584,0.127510917
H85055,7414,6244,6162,6078,4448,2833,6126,1288,0.173725384
H85057,7221,5606,5544,5489,4271,1594,6684,537,0.074366431
H85061,19909,17256,17138,17019,12514,4179,18232,1677,0.084233261
H85063,14156,11805,11653,11490,8114,6056,11138,3018,0.213195818
H85065,3851,3116,3067,3013,2124,946,3472,379,0.098415996
H85066,19414,16463,16347,16233,10992,3504,18145,1269,0.0653652
H85067,3134,2478,2429,2381,1668,825,2830,304,0.097000638
H85069,13369,11310,11246,11153,7897,2822,12313,1056,0.078988705
H85070,9028,7088,6941,6818,5107,2496,8142,886,0.098139123
H85075,5203,4425,4405,4382,3166,906,4871,332,0.063809341
H85076,8826,7403,7303,7191,5054,3589,7193,1633,0.185021527
H85077,5955,5047,5000,4965,3618,1565,5242,713,0.119731318
H85078,3736,3037,2994,2961,2147,1106,3293,443,0.118576017
H85082,4837,4075,4031,3981,2889,1243,4351,486,0.100475501
H85087,9538,8347,8271,8193,6131,3097,8274,1264,0.132522541
H85088,2655,2327,2305,2290,1734,781,2328,327,0.123163842
H85090,8684,6941,6840,6742,4932,2242,7870,814,0.093735606
H85092,5844,4680,4622,4559,3513,1436,5265,579,0.099075975
H85095,13223,10069,9950,9818,7436,3383,11789,1434,0.108447402
H85100,7950,6620,6543,6478,4796,1690,7280,670,0.08427673
H85101,8740,6947,6864,6788,5211,2707,7475,1265,0.144736842
H85103,5567,4244,4186,4130,3170,1295,5112,455,0.081731633
H85105,13533,10834,10643,10474,7649,4759,11504,2029,0.149929801
H85110,5372,4299,4241,4178,3111,1721,4714,658,0.122486969
H85111,11936,10097,9981,9881,6910,2593,11050,886,0.074229223
H85112,4763,3943,3907,3870,2811,1218,4350,413,0.086710057
H85113,3821,3106,3061,3016,2214,1489,3181,640,0.16749542
H85114,14340,10956,10806,10675,7781,3287,13287,1053,0.073430962
H85115,13951,11413,11244,11087,8012,5534,11497,2454,0.175901369
H85116,9063,6989,6872,6748,4924,2574,8100,963,0.106256207
H85618,9614,7541,7434,7343,5500,3147,8183,1431,0.148845434
H85634,8256,6878,6832,6783,5223,1377,7810,446,0.054021318
H85637,1417,1159,1141,1118,844,559,1171,246,0.17360621
H85649,11237,9293,9178,9082,6659,2988,10219,1018,0.090593575
H85653,16365,12932,12756,12589,9221,5687,13492,2873,0.175557592
H85656,5795,4933,4882,4830,3683,1517,5228,567,0.097842968
H85659,7943,7010,6986,6968,4656,882,7706,237,0.029837593
H85662,5929,4822,4740,4656,3579,2335,4883,1046,0.176420982
H85664,2441,2356,2352,2349,1375,328,2370,71,0.02908644
H85665,2666,2100,2068,2031,1464,805,2357,309,0.115903976
H85680,10574,8545,8448,8357,6086,2003,9960,614,0.058066957
H85682,9206,7285,7161,7037,4840,1880,8548,658,0.071475125
H85683,5282,4103,4010,3937,2852,1518,4676,606,0.114729269
H85686,9639,7794,7699,7618,5796,3278,8140,1499,0.155514057
H85691,149,149,149,149,13,149,3,146,0.979865772
H85693,11313,8414,8229,8062,5900,2781,10434,879,0.077698223
H85695,3214,2695,2663,2634,1884,885,2869,345,0.107342875
J81002,8881,7868,7785,7715,4928,5379,5318,3563,0.401193559
J81003,6732,5583,5524,5463,3978,1971,5904,828,0.122994652
J81004,10040,9006,8962,8915,6072,3492,8090,1950,0.194223108
J81005,18055,15579,15415,15253,10798,9958,12200,5855,0.324286901
J81006,34128,28073,27702,27355,19331,14440,26691,7437,0.217914909
J81009,12342,10201,10057,9921,7263,5675,9496,2846,0.230594717
J81010,11110,9796,9682,9566,6468,6356,7275,3835,0.345184518
J81011,7932,6756,6686,6615,4589,4267,5390,2542,0.320474029
J81012,17904,14620,14438,14268,10430,6442,14947,2957,0.165158624
J81013,12286,9898,9755,9621,7106,4828,10003,2283,0.18582126
J81014,18415,16474,16391,16300,11296,8403,13355,5060,0.274775998
J81016,7909,6681,6608,6514,4482,3731,5821,2088,0.264003035
J81017,4256,3466,3303,3150,2112,2041,3081,1175,0.276080827
J81018,11518,9570,9447,9341,6774,4726,9021,2497,0.21679111
J81019,24585,20150,19894,19604,14236,11502,18366,6219,0.252959121
J81020,3644,3131,3091,3055,2258,1901,2676,968,0.265642151
J81021,25471,21693,21519,21312,15254,7824,21998,3473,0.136351144
J81022,5696,5065,5034,4984,3110,3622,3183,2513,0.441186798
J81025,6025,5082,5018,4958,3505,2868,4507,1518,0.251950207
J81027,19447,16926,16765,16611,11731,10129,13768,5679,0.292024477
J81028,12601,11093,10991,10906,7036,7735,7368,5233,0.415284501
J81029,5652,4968,4914,4865,3233,3322,3594,2058,0.364118896
J81030,8064,6766,6695,6622,4612,3975,5853,2211,0.274181548
J81033,23550,20681,20510,20341,9229,6358,20255,3295,0.139915074
J81034,14402,11948,11585,11246,7548,6773,10391,4011,0.278502986
J81035,4025,3425,3341,3261,2338,2004,3017,1008,0.250434783
J81036,8718,7188,7092,7013,4909,3473,6994,1724,0.197751778
J81039,9254,7315,7224,7124,5258,3212,7791,1463,0.158093797
J81041,19763,16576,16310,16092,11289,9590,14435,5328,0.269594697
J81042,9878,8778,8717,8635,4397,3132,8262,1616,0.16359587
J81044,14142,11423,11307,11148,8071,5478,11392,2750,0.19445623
J81045,10629,8765,8644,8532,5930,4569,8247,2382,0.224103867
J81046,12224,10459,10329,10202,7189,6114,8705,3519,0.287876309
J81047,12704,10240,10089,9951,7287,5072,10217,2487,0.195765113
J81048,6837,5661,5599,5540,4031,3120,5173,1664,0.2433816
J81049,9101,7780,7707,7616,5407,4400,6582,2519,0.276782771
J81051,15438,12864,12693,12487,8931,7113,11767,3671,0.237789869
J81052,6195,5310,5254,5204,3619,2602,4835,1360,0.219531881
J81053,4077,3565,3541,3516,2457,2467,2661,1416,0.347314202
J81054,9990,8477,8366,8260,5869,5343,6848,3142,0.314514515
J81056,19471,16689,16476,16281,11060,9919,13849,5622,0.288737096
J81057,6417,5525,5467,5413,3689,3344,4349,2068,0.322268973
J81058,10762,8933,8806,8688,6119,4886,8235,2527,0.234807657
J81059,10027,8242,8129,8041,5897,4010,8016,2011,0.200558492
J81061,8107,7281,7217,7156,4451,5057,4677,3430,0.423091156
J81062,11064,9054,8942,8833,6380,4181,8958,2106,0.190347072
J81064,4334,3715,3681,3649,2518,1933,3205,1129,0.260498385
J81066,10389,8602,8480,8369,5912,4612,7872,2517,0.242275484
J81067,5521,4550,4499,4441,3213,2138,4524,997,0.180583228
J81068,7106,6067,6009,5940,4079,3584,5053,2053,0.28891078
J81070,9456,7894,7814,7731,5545,3823,7466,1990,0.210448393
J81071,3848,3228,3188,3150,2217,1792,2897,951,0.247141372
J81072,15482,13584,13499,13415,8603,3865,13594,1888,0.121948069
J81073,16409,13663,13504,13349,9388,7527,12399,4010,0.244378085
J81074,5285,4648,4602,4558,3153,3258,3332,1953,0.369536424
J81075,5823,5020,4955,4888,3573,3013,4214,1609,0.276318049
J81076,6136,5252,5188,5126,3706,3371,4272,1864,0.303780965
J81077,6473,5455,5376,5300,3868,3230,4844,1629,0.251660745
J81078,12600,10541,10355,10125,6870,6336,8886,3714,0.294761905
J81081,12685,10626,10493,10351,7234,6050,9378,3307,0.260701616
J81082,7045,5999,5930,5846,4081,3488,5132,1913,0.271540099
J81083,4237,3537,3500,3463,2527,2335,2971,1266,0.298796318
J81086,6861,5716,5655,5590,4015,2765,5542,1319,0.192246028
J81087,9481,7765,7659,7572,5643,3834,7854,1627,0.171606371
J81609,3043,2696,2666,2641,1901,1901,1913,1130,0.371344068
J81612,2772,2396,2372,2346,1698,1563,1887,885,0.319264069
J81613,6662,5657,5597,5535,3977,3173,4983,1679,0.252026418
J81616,4229,3606,3566,3523,2614,2223,3099,1130,0.267202648
J81620,25936,21600,21307,21006,14806,12749,18865,7071,0.272632634
J81621,6901,5690,5616,5542,3877,3112,5227,1674,0.24257354
J81625,9936,7952,7854,7753,5601,3154,8586,1350,0.135869565
J81626,4844,4020,3958,3906,2702,2132,3683,1161,0.239677952
J81628,2374,2122,2091,2068,1377,1562,1402,972,0.409435552
J81631,2401,2083,2065,2037,1450,1310,1693,708,0.294877135
J81633,3644,3007,2952,2906,2089,1422,2961,683,0.187431394
J81634,15030,12601,12482,12352,9168,4234,13434,1596,0.106187625
J81637,6397,5320,5252,5177,3623,3085,4700,1697,0.2652806
J81644,3529,3009,2967,2927,2148,1774,2559,970,0.274865401
J81646,6146,5108,5042,4967,3404,2863,4510,1636,0.266189391
J81647,6593,5699,5621,5542,3947,3809,4483,2110,0.320036402
J81648,4396,3713,3677,3644,2623,1767,3551,845,0.1922202
J82001,9465,7596,7495,7392,4799,2290,8499,966,0.102060222
J82002,12041,9691,9572,9457,6930,4236,9858,2183,0.181297234
J82005,4392,3752,3703,3661,2680,2270,3242,1150,0.261839709
J82006,10733,8868,8752,8644,6064,4749,8250,2483,0.231342588
J82007,13344,11469,11343,11206,7571,6987,9202,4142,0.310401679
J82008,7802,6598,6525,6441,4495,3849,5713,2089,0.267751858
J82009,13027,11057,10903,10779,7382,6942,8935,4092,0.314116834
J82010,18980,15449,15258,15073,10768,7690,15205,3775,0.198893572
J82012,9831,8269,8169,8084,5806,4522,7414,2417,0.245854949
J82015,9575,7649,7538,7465,5433,3376,8010,1565,0.163446475
J82016,8978,7458,7360,7262,5343,4591,6654,2324,0.258854979
J82017,14012,11479,11353,11211,7966,5898,11090,2922,0.208535541
J82018,18058,14767,14571,14399,10302,7582,14298,3760,0.208217964
J82019,14544,11842,11698,11559,8275,6340,10959,3585,0.246493399
J82020,6568,5346,5275,5208,3811,2353,5439,1129,0.171894032
J82021,8668,7627,7555,7483,5110,5121,5565,3103,0.357983387
J82022,12168,10165,10033,9917,6942,4622,9761,2407,0.197813938
J82023,12929,10223,10029,9903,7542,4326,11279,1650,0.127620079
J82024,19327,15347,15184,15026,9907,3771,17902,1425,0.07373105
J82025,13427,10941,10798,10653,7698,5228,11047,2380,0.177254785
J82026,14948,12834,12687,12574,8447,7178,10866,4082,0.273080011
J82028,23673,19912,19726,19519,14573,8582,19755,3918,0.165505006
J82029,9694,8402,8326,8250,5409,5204,6444,3250,0.335258923
J82033,8907,7357,7251,7169,5241,3836,6995,1912,0.214662625
J82034,13038,10725,10586,10455,7641,5997,10008,3030,0.232397607
J82035,17389,14869,14589,14266,8145,6375,13817,3572,0.205417218
J82036,2686,2281,2244,2220,1693,1379,2018,668,0.248696947
J82039,11167,9571,9462,9355,6271,5669,7837,3330,0.298200054
J82040,14802,11286,11127,10975,7877,4470,12738,2064,0.139440616
J82041,7639,5990,5883,5791,4076,2699,6487,1152,0.150805079
J82042,14285,11592,11459,11339,8359,5655,11683,2602,0.182149107
J82044,9908,8042,7947,7850,5773,4303,7772,2136,0.215583367
J82049,28151,23407,23086,22784,16582,11995,22157,5994,0.212923164
J82050,19738,16255,16085,15910,10090,5879,17081,2657,0.134613436
J82051,12675,10506,10382,10262,7579,5537,9992,2683,0.211676529
J82053,9008,7492,7403,7325,5242,3743,7145,1863,0.206816163
J82054,9025,7315,7217,7122,5310,4090,7029,1996,0.221163435
J82055,11751,10154,10050,9942,7078,4779,9365,2386,0.203046549
J82056,23363,19509,19253,19019,13393,10950,17481,5882,0.251765612
J82058,19263,15188,15000,14834,10964,5647,16905,2358,0.122410839
J82059,7178,6079,5985,5891,4314,3606,5389,1789,0.24923377
J82060,13322,10738,10604,10481,7466,4568,11215,2107,0.158159436
J82061,11614,9378,9232,9083,6590,5024,9099,2515,0.216548993
J82062,15585,12286,12093,11928,8615,4793,13494,2091,0.134167469
J82063,8736,7060,6961,6875,4842,3056,7331,1405,0.160828755
J82064,13205,10958,10810,10689,7830,6233,10030,3175,0.240439228
J82066,22629,18156,17905,17667,12667,7840,19194,3435,0.151796367
J82067,18047,14729,14571,14394,10749,6450,15317,2730,0.15127168
J82069,43026,35325,34836,34317,25044,16265,35608,7418,0.172407382
J82071,10836,8547,8435,8323,6009,3282,9384,1452,0.133997785
J82072,11762,9478,9345,9209,6627,4950,9271,2491,0.21178371
J82073,9074,7397,7302,7186,5142,3383,7638,1436,0.158254353
J82074,14469,12029,11878,11747,8160,6696,10623,3846,0.265809662
J82075,6911,5923,5863,5799,4000,3746,4713,2198,0.318043698
J82076,15217,12400,12270,12135,8688,5612,12516,2701,0.17749885
J82077,13835,10849,10697,10545,7706,4073,12033,1802,0.130249368
J82079,7128,5706,5618,5545,4197,2757,5909,1219,0.171015713
J82080,19579,18830,18816,18798,3946,692,19323,256,0.013075234
J82081,24478,21410,21299,21187,11342,3950,23022,1456,0.059481984
J82082,12815,9706,9555,9417,6917,3414,11414,1401,0.10932501
J82083,35381,29022,28656,28320,20474,14832,28332,7049,0.199231226
J82084,4321,3676,3641,3600,2536,2080,3250,1071,0.247859292
J82085,15649,12286,12092,11908,8304,4738,13558,2091,0.133618762
J82087,7210,6028,5959,5872,4063,2707,5868,1342,0.186130374
J82088,13840,11256,11092,10933,8064,4648,11780,2060,0.148843931
J82089,16639,13447,13268,13103,9311,6613,13160,3479,0.209087085
J82090,13653,10906,10757,10633,7918,4391,11842,1811,0.13264484
J82092,8221,6533,6431,6342,4616,2687,6856,1365,0.166038195
J82094,19523,16217,16009,15808,11628,8862,15145,4378,0.224248322
J82098,20379,16843,16555,16243,11424,9017,15654,4725,0.231856323
J82099,14137,11127,10940,10794,7929,5179,11595,2542,0.179811841
J82101,19741,16242,16016,15778,11232,7875,16018,3723,0.18859227
J82102,18637,15230,15006,14797,10414,7836,14634,4003,0.214787788
J82103,12641,10221,10098,9984,7132,4828,10319,2322,0.183687999
J82104,12872,11056,10920,10800,7417,7132,8622,4250,0.330174021
J82106,6800,5478,5389,5322,3977,3035,5262,1538,0.226176471
J82110,14664,11852,11667,11471,8396,5642,11982,2682,0.18289689
J82112,24717,20664,20395,20141,14492,10780,19386,5331,0.215681515
J82114,9699,7796,7686,7565,5330,3345,8185,1514,0.156098567
J82115,5503,4588,4552,4516,3138,1347,4969,534,0.097037979
J82116,9650,7831,7697,7574,5642,4325,7467,2183,0.226217617
J82117,14124,11193,11023,10881,7890,4594,12216,1908,0.13508921
J82119,9458,7980,7882,7795,5577,4773,6952,2506,0.26496088
J82120,9495,7875,7758,7656,5556,3732,7575,1920,0.20221169
J82121,9737,7929,7826,7723,5641,4038,7728,2009,0.206326384
J82122,9825,8320,8227,8150,5652,3063,8444,1381,0.140559796
J82124,9657,8068,7940,7810,5547,4857,7048,2609,0.270166718
J82125,8853,7290,7189,7106,5178,3521,7295,1558,0.175985542
J82126,4739,3914,3871,3831,2669,1656,3839,900,0.189913484
J82128,8955,7326,7232,7133,5182,3244,7402,1553,0.173422669
J82129,7842,6751,6678,6602,4563,4333,5332,2510,0.32007141
J82130,24280,19632,19288,18941,12905,9113,19825,4455,0.183484349
J82131,12446,10592,10471,10355,7406,6675,8765,3681,0.295757673
J82132,13154,10918,10788,10656,7472,5695,10262,2892,0.219857078
J82133,5763,4649,4601,4547,3251,2386,4606,1157,0.200763491
J82134,27229,22422,22121,21860,15214,11389,21438,5791,0.21267766
J82135,13440,10858,10741,10588,7647,5309,10783,2657,0.197693452
J82136,9785,8195,8063,7954,5745,4427,7655,2130,0.217680123
J82138,17813,14539,14339,14150,10556,7595,14203,3610,0.202660978
J82139,15731,13579,13450,13338,8979,9072,10002,5729,0.364185366
J82142,9824,7966,7877,7797,5828,3463,8296,1528,0.155537459
J82143,16816,13700,13474,13272,9735,7273,13242,3574,0.21253568
J82144,26697,22140,21903,21663,15532,8846,22654,4043,0.151440237
J82145,18512,15627,15397,15219,10932,8987,13683,4829,0.260857822
J82146,5415,4712,4659,4612,3264,2947,3765,1650,0.304709141
J82147,8039,6610,6513,6452,4762,3633,6330,1709,0.21258863
J82149,13386,10666,10508,10370,7543,4369,11558,1828,0.136560586
J82150,11935,10116,9991,9858,6969,6379,8238,3697,0.309761207
J82151,4675,3976,3928,3888,2833,2524,3296,1379,0.294973262
J82152,8639,7243,7152,7056,4985,3720,6742,1897,0.2195856
J82154,15556,12863,12710,12537,8874,6878,12123,3433,0.220686552
J82155,43835,34792,34331,33789,24237,14708,37132,6703,0.152914338
J82156,7457,6494,6425,6375,4333,3716,5353,2104,0.282150999
J82157,15031,12453,12280,12117,8406,6380,11579,3452,0.229658705
J82161,10429,8859,8751,8665,6201,5075,7672,2757,0.264358999
J82163,16100,13538,13384,13224,9318,7515,12035,4065,0.252484472
J82164,11345,9238,9110,8964,6382,5026,8818,2527,0.222741296
J82166,10776,9697,9612,9511,6166,6798,6386,4390,0.407386785
J82169,7475,5917,5844,5772,4340,2466,6397,1078,0.144214047
J82174,13554,11309,11132,10984,8008,5964,10806,2748,0.202744577
J82177,4333,3466,3421,3386,2306,1281,3722,611,0.141010847
J82178,9846,8139,8037,7955,5593,3159,8297,1549,0.157322771
J82180,6086,4912,4853,4781,3476,2330,5028,1058,0.173841604
J82181,9328,7611,7518,7429,5262,3161,7923,1405,0.150621784
J82183,6219,5279,5228,5171,3660,2381,5064,1155,0.185721177
J82184,3332,2744,2707,2676,1969,1229,2862,470,0.141056423
J82188,4549,3669,3624,3586,2642,1421,3998,551,0.121125522
J82192,11244,8632,8476,8336,6318,3688,9717,1527,0.135805763
J82194,13199,10908,10756,10641,7725,5271,10782,2417,0.183119933
J82196,14656,11854,11691,11523,8081,5848,11723,2933,0.200122817
J82197,3688,3056,3017,2980,2142,1855,2774,914,0.247830803
J82198,3741,3050,3016,2991,1995,1269,3085,656,0.175354183
J82199,20431,20049,20022,19983,4054,558,20221,210,0.010278498
J82201,7674,6193,6109,6019,4413,3332,6006,1668,0.21735731
J82207,9455,8101,8031,7975,5513,2672,8248,1207,0.127657324
J82208,5672,4581,4517,4470,3231,1932,4779,893,0.157440056
J82210,9429,8269,8180,8096,5536,5427,6217,3212,0.340651183
J82213,5615,4386,4332,4264,3121,1600,4966,649,0.115583259
J82214,9179,7465,7391,7296,5433,3782,7335,1844,0.200893344
J82215,11958,9896,9751,9619,6797,5848,8619,3339,0.279227296
J82216,12124,10002,9869,9755,6847,5597,9017,3107,0.256268558
J82217,486,486,486,486,399,99,479,7,0.014403292
J82218,14511,11426,11268,11121,8496,4224,12905,1606,0.110674661
J82220,6967,5166,5070,4983,3943,1690,6447,520,0.074637577
J82605,4108,3693,3672,3660,1849,607,3831,277,0.067429406
J82622,27182,21601,21308,21030,15298,9187,23058,4124,0.151718049
J82625,4119,3470,3432,3401,2496,2064,3039,1080,0.262199563
J82628,5329,4130,4070,4011,2907,2037,4321,1008,0.189153687
J82630,5366,4086,4038,3995,2953,1305,4868,498,0.09280656
J82633,4349,3718,3661,3615,2675,2104,3318,1031,0.237065992
J82639,18007,14974,14790,14618,10793,8384,13626,4381,0.243294274
J82640,5674,4639,4575,4520,3285,2405,4522,1152,0.203031371
J82646,9306,7194,7082,6983,5040,3171,7964,1342,0.144208038
J82663,6829,6336,6315,6291,2002,710,6494,335,0.049055499
J82669,7286,5317,5229,5134,3670,2067,6391,895,0.12283832
J83001,13910,11731,11573,11439,8008,6442,10558,3352,0.240977714
J83002,27724,21693,21369,21075,15722,9365,23257,4467,0.161123936
J83003,12534,10421,10277,10129,7007,5767,9254,3280,0.261688208
J83004,6648,5597,5512,5441,3961,3502,4777,1871,0.281438026
J83005,10858,8575,8459,8332,5993,4114,8943,1915,0.176367655
J83006,10887,9053,8912,8797,6341,4930,8441,2446,0.224671627
J83007,15564,12663,12451,12254,8822,5859,12990,2574,0.16538165
J83008,18702,15236,15015,14808,10486,7243,14977,3725,0.199176559
J83009,13841,11383,11236,11100,7844,6179,10601,3240,0.234087132
J83010,11459,9262,9123,8993,6560,4930,8817,2642,0.230561131
J83011,14184,11876,11745,11632,7976,6769,10409,3775,0.266144952
J83013,7287,5996,5917,5856,4232,3470,5432,1855,0.25456292
J83014,14573,10950,10798,10642,7674,4887,12326,2247,0.154189254
J83016,30922,25173,24823,24494,17561,11982,25196,5726,0.185175603
J83018,17916,15168,14888,14665,10063,8749,13067,4849,0.270651931
J83019,11470,9751,9640,9551,6907,6174,8074,3396,0.296076722
J83021,23837,19064,18783,18535,13379,8948,19559,4278,0.179468893
J83022,8940,7301,7208,7118,5330,2965,7759,1181,0.132102908
J83023,7682,6117,6032,5959,4379,3371,6023,1659,0.215959386
J83024,8904,7026,6933,6816,4769,3206,7338,1566,0.175876011
J83025,5345,4374,4301,4233,3117,2003,4473,872,0.163143124
J83026,24048,20204,19969,19718,13866,11165,18128,5920,0.246174318
J83027,12549,10100,9966,9825,7174,4743,10334,2215,0.176508088
J83029,8228,6860,6774,6689,4619,3936,6127,2101,0.255347594
J83030,20228,16793,16486,16194,11534,9416,15038,5190,0.256575044
J83031,12152,9473,9361,9247,6706,4183,10202,1950,0.160467413
J83033,12642,10298,10187,10085,7180,3326,11298,1344,0.106312292
J83034,7317,6231,6117,5998,4046,3663,5303,2014,0.275249419
J83035,18109,13915,13641,13391,9883,5700,15830,2279,0.125849025
J83036,10701,8708,8600,8511,6515,4105,8993,1708,0.159611251
J83037,17269,14347,13970,13601,9437,8355,12865,4404,0.255023452
J83038,10526,8339,8210,8109,5610,3639,8944,1582,0.150294509
J83039,11360,9207,9121,9012,6366,4873,8865,2495,0.219630282
J83040,22610,18436,18164,17913,12832,9381,17933,4677,0.206855374
J83041,16100,13191,13015,12823,9347,7351,12344,3756,0.233291925
J83042,16492,13826,13636,13442,9343,7146,12895,3597,0.218105748
J83043,6942,5898,5829,5764,4035,3630,4929,2013,0.289974071
J83045,9238,7702,7605,7500,5431,4443,7059,2179,0.235873566
J83046,12519,10121,9976,9838,7131,5369,9851,2668,0.213116064
J83047,7655,6134,6049,5950,4352,2838,6269,1386,0.181058132
J83048,5933,4831,4762,4700,3389,2452,4743,1190,0.200573066
J83049,11583,9479,9372,9245,6641,4985,9175,2408,0.207890875
J83050,16880,13513,13248,12992,9680,6895,13764,3116,0.184597156
J83052,10132,7975,7871,7761,5718,3476,8667,1465,0.144591394
J83053,6804,5680,5626,5551,3892,3162,5142,1662,0.244268078
J83055,10143,8313,8192,8089,5987,4408,8010,2133,0.210292813
J83056,5733,4872,4793,4734,3514,2969,4303,1430,0.249433107
J83057,15412,12330,12165,12012,8742,5545,12776,2636,0.171035557
J83058,4006,3429,3392,3361,2412,2173,2846,1160,0.289565652
J83059,7894,6393,6306,6221,4498,3252,6320,1574,0.199391943
J83060,4689,4023,3973,3917,2674,2606,3171,1518,0.323736404
J83064,11089,8663,8529,8394,6398,3603,9762,1327,0.11966814
J83601,3965,3275,3230,3183,2398,1888,3079,886,0.223455233
J83603,4686,3901,3836,3783,2833,2288,3628,1058,0.225778916
J83609,2865,2370,2341,2317,1757,1334,2127,738,0.257591623
J83615,3664,3034,2991,2951,2221,1787,2818,846,0.230895197
J83618,3464,2868,2822,2776,2092,1668,2684,780,0.22517321
J83619,2729,2351,2322,2291,1696,1517,1949,780,0.285818981
J83625,8093,6673,6563,6458,4812,3172,7019,1074,0.132707278
J83629,1970,1724,1710,1691,1202,1189,1238,732,0.371573604
J83630,2401,2046,2029,2008,1440,1365,1623,778,0.324031653
J83633,9238,7763,7681,7604,5622,3592,7555,1683,0.182182291
J83645,4491,3692,3633,3589,2691,1669,3887,604,0.134491205
J83646,6709,5419,5348,5285,3867,1995,5887,822,0.122521985
J84003,4959,4281,4239,4198,3016,2817,3303,1656,0.333938294
J84004,8827,7267,7172,7066,5090,4013,6566,2261,0.256145916
J84005,9583,8311,8200,8127,5774,4877,6904,2679,0.27955755
J84007,7071,6207,6143,6079,4091,4418,4202,2869,0.405741762
J84008,5538,4655,4580,4506,3199,2655,4117,1421,0.256590827
J84010,13260,11493,11394,11290,7936,7235,9176,4084,0.307993967
J84011,23849,19546,19284,19039,13395,10048,18699,5150,0.215941968
J84012,13206,10942,10793,10676,7666,5792,10283,2923,0.221338785
J84013,13784,11838,11731,11608,8141,7169,9744,4040,0.293093442
J84015,15267,12734,12585,12416,8985,7078,11542,3725,0.243990306
J84016,6086,5383,5324,5260,3796,3793,3810,2276,0.373973053
J84017,9115,7721,7641,7556,5266,4451,6645,2470,0.270981898
J84018,3691,3255,3223,3188,2241,2086,2536,1155,0.312923327
J84019,10681,9529,9446,9374,6311,6722,6368,4313,0.403801142
J84020,16,13,13,13,10,10,11,5,0.3125
K81001,13702,11016,10877,10721,7882,4763,11709,1993,0.145453219
K81002,14040,11259,11098,10919,7991,4119,12201,1839,0.130982906
K81003,13387,10449,10307,10170,7737,4609,11267,2120,0.158362591
K81004,14895,11956,11799,11621,8341,5589,12078,2817,0.189123867
K81005,4418,3374,3313,3249,2424,1030,3994,424,0.095971028
K81006,19544,16076,15842,15633,11676,7909,15948,3596,0.183995088
K81007,5450,4664,4633,4603,3378,1336,4914,536,0.098348624
K81010,7577,6156,6042,5937,4333,3177,6174,1403,0.185165633
K81012,11787,9655,9511,9351,6952,5152,9253,2534,0.214982608
K81014,20628,16388,16177,15948,11918,7390,17084,3544,0.171805313
K81015,3435,2716,2683,2647,2076,1298,2831,604,0.175836972
K81017,13689,11291,11129,10993,7887,5981,10550,3139,0.229308204
K81018,10164,8303,8180,8068,5930,4127,8076,2088,0.205430933
K81019,3514,2714,2682,2644,1961,856,3149,365,0.103870233
K81020,19394,15785,15553,15345,11379,6902,15936,3458,0.178302568
K81021,10145,8361,8278,8174,6011,4100,8196,1949,0.192114342
K81022,22711,18431,18203,17961,12848,9146,17793,4918,0.216547048
K81024,20048,15217,14969,14740,11161,5457,17782,2266,0.113028731
K81025,16486,13282,13054,12851,9704,6865,13399,3087,0.187249788
K81026,6863,5576,5500,5427,4054,2024,6165,698,0.101704794
K81027,11133,9031,8875,8738,6414,4849,8729,2404,0.215934609
K81028,8995,7372,7217,7035,4959,4017,7120,1875,0.208449138
K81030,22826,18260,17791,17335,12604,7975,18911,3915,0.171514939
K81034,11878,9334,9211,9072,6673,2767,10876,1002,0.084357636
K81036,11181,9086,8972,8870,6487,3633,9502,1679,0.150165459
K81039,7419,5526,5420,5326,3895,2036,6633,786,0.105944197
K81040,14598,11760,11594,11448,8223,4435,12763,1835,0.125702151
K81041,12087,9797,9629,9476,6928,4613,9726,2361,0.19533383
K81042,7897,6467,6373,6294,4667,3589,6167,1730,0.219070533
K81043,15953,12300,12136,11969,8953,3851,14388,1565,0.098100671
K81045,15956,12523,12283,12056,8597,5198,13624,2332,0.146151918
K81046,6908,5711,5627,5575,4132,2570,5743,1165,0.168645049
K81047,27553,22027,21678,21339,16251,9801,23429,4124,0.149675171
K81048,6445,5070,4985,4907,3514,1807,5759,686,0.1064391
K81050,11182,8828,8638,8481,6414,4469,9243,1939,0.173403684
K81051,12662,9937,9795,9683,7071,4176,10715,1947,0.153767177
K81052,6550,5531,5468,5411,3951,2927,5130,1420,0.216793893
K81055,7199,5963,5898,5816,4181,3399,5446,1753,0.243506043
K81056,4548,3735,3689,3646,2679,1848,3640,908,0.199648197
K81057,7386,6151,6082,5997,4354,3355,5670,1716,0.232331438
K81059,9992,8068,7908,7752,5824,3926,8284,1708,0.170936749
K81060,11744,9363,9235,9134,6886,3859,10230,1514,0.128916894
K81062,27338,22189,21946,21682,15784,8417,23642,3696,0.13519643
K81063,21878,18009,17820,17615,12755,7979,17972,3906,0.178535515
K81066,12088,9829,9688,9525,7088,4742,9995,2093,0.173146923
K81068,10328,8754,8659,8581,6472,4135,8556,1772,0.171572424
K81069,14830,12184,12023,11861,8601,6284,11691,3139,0.211665543
K81070,13042,10424,10234,10072,7653,4875,10812,2230,0.170986045
K81073,18536,14937,14701,14499,10681,6950,15255,3281,0.177006905
K81074,16938,14975,14857,14748,6362,3664,15302,1636,0.096587555
K81075,26648,20130,19796,19516,14613,6689,24192,2456,0.092164515
K81076,10021,8373,8239,8111,5787,4785,7620,2401,0.239596847
K81077,10926,8828,8699,8582,6434,4137,9112,1814,0.166025993
K81078,14101,11309,11159,11001,7894,4647,11990,2111,0.149705695
K81080,7857,6352,6260,6178,4529,3269,6232,1625,0.206821942
K81081,2406,2009,1987,1966,1501,536,2208,198,0.082294264
K81082,11281,8523,8360,8215,6337,2998,10224,1057,0.093697367
K81083,13159,9808,9637,9440,6821,2968,11869,1290,0.098031765
K81084,7024,5794,5733,5673,4395,2677,5763,1261,0.179527335
K81085,6355,5072,5009,4932,3698,1850,5576,779,0.122580645
K81086,10694,8280,8128,7985,5762,2988,9436,1258,0.117636058
K81087,5605,4433,4377,4310,3187,1640,4977,628,0.112042819
K81089,3449,2783,2745,2707,1976,1004,3093,356,0.103218324
K81092,13810,10701,10519,10352,8115,4679,11779,2031,0.147067343
K81094,4184,3292,3246,3203,2396,1183,3686,498,0.119024857
K81097,6248,4938,4852,4767,3589,2248,5208,1040,0.166453265
K81100,5021,4124,4080,4042,3003,1277,4606,415,0.082652858
K81102,10478,8202,8000,7800,5867,3556,9160,1318,0.125787364
K81103,8115,6477,6219,6005,4445,3371,6555,1560,0.192236599
K81605,31350,27629,27468,27305,12645,3829,29836,1514,0.048293461
K81607,3633,2726,2670,2607,1775,782,3272,361,0.099366914
K81608,5510,4028,3941,3862,2895,1052,5136,374,0.067876588
K81610,20100,16033,15835,15637,11919,6426,17689,2411,0.119950249
K81613,5289,4235,4170,4099,2963,1419,4719,570,0.107770845
K81616,5008,3889,3830,3778,2796,1373,4431,577,0.115215655
K81622,2473,2061,2037,2017,1468,877,2036,437,0.176708451
K81630,14133,10810,10419,10050,7313,4456,12051,2082,0.147314795
K81633,9690,7362,7236,7128,5232,2342,8761,929,0.095872033
K81636,8459,6594,6498,6410,4887,1804,7863,596,0.070457501
K81638,3379,2493,2450,2401,1860,860,3045,334,0.098845812
K81644,16262,13594,13452,13309,7717,4580,14462,1800,0.110687492
K81645,6445,4830,4753,4680,3298,1214,6015,430,0.066718386
K81651,14063,11586,11472,11358,8553,3180,12890,1173,0.083410368
K81655,5347,4277,4211,4148,3210,1924,4530,817,0.15279596
K81656,5625,4425,4362,4316,3350,1555,5067,558,0.0992
K81657,5110,3961,3911,3857,2952,1021,4841,269,0.052641879
K82001,9730,8044,7920,7802,5482,4538,7310,2420,0.248715313
K82003,16116,12181,11957,11744,8702,4098,14444,1672,0.103747828
K82004,13346,10415,10228,10068,7450,4942,10888,2458,0.184175034
K82006,9403,7749,7647,7550,5500,3836,7655,1748,0.185898118
K82007,30455,24688,24165,23627,16317,11318,25271,5184,0.170218355
K82008,9842,8023,7905,7759,5486,4282,7695,2147,0.218146718
K82009,11174,9366,9220,9111,6763,5053,8496,2678,0.239663505
K82010,10888,8484,8352,8238,6135,3117,9518,1370,0.125826598
K82011,7900,6249,6136,6024,4436,3006,6447,1453,0.183924051
K82012,6873,5589,5493,5402,3914,3034,5241,1632,0.237450895
K82013,13404,11151,11014,10886,7900,5709,10447,2957,0.220605789
K82014,5738,4686,4604,4532,3282,2202,4790,948,0.16521436
K82015,10924,8701,8589,8475,6124,3884,9007,1917,0.17548517
K82016,22454,18273,18064,17860,13328,8877,17759,4695,0.209094148
K82017,12675,10016,9862,9697,6816,4034,10735,1940,0.153057199
K82018,15808,11891,11702,11527,8377,4274,14155,1653,0.104567308
K82019,15285,12045,11849,11670,8593,4449,13636,1649,0.107883546
K82020,6616,5618,5535,5458,3666,2550,5485,1131,0.170949214
K82021,14429,12156,11998,11852,8439,7115,10595,3834,0.26571488
K82022,10135,7673,7537,7389,5484,2948,8902,1233,0.121657622
K82023,27303,22134,21782,21481,15653,12163,21034,6269,0.229608468
K82024,10944,8914,8775,8661,6278,4107,8985,1959,0.179002193
K82025,10873,8975,8855,8743,6498,4234,8744,2129,0.195806125
K82026,14061,11177,11043,10896,7910,5073,11623,2438,0.173387384
K82027,6988,5576,5467,5378,3991,2232,6005,983,0.14066972
K82028,8618,7062,6974,6887,5020,3946,6443,2175,0.252378742
K82029,10782,8618,8515,8418,6237,3919,8916,1866,0.173066221
K82030,10300,8099,7892,7692,5328,3032,8925,1375,0.133495146
K82031,6408,5151,5061,4951,3566,2568,5201,1207,0.188358302
K82032,12359,9615,9456,9349,7110,3627,10849,1510,0.12217817
K82033,20951,16898,16672,16466,12296,7914,17288,3663,0.174836523
K82035,3571,2849,2806,2772,2025,1506,2826,745,0.208625035
K82036,9845,7883,7788,7681,5341,3355,8276,1569,0.159370239
K82037,12572,10345,10193,10060,7281,5255,10088,2484,0.197581928
K82038,20668,16588,16387,16205,11920,7366,17361,3307,0.160005806
K82039,14064,11264,11090,10923,7860,4183,12270,1794,0.127559727
K82040,14593,11399,11247,11096,8174,4028,12855,1738,0.119098198
K82042,4021,3368,3331,3282,2445,2028,3017,1004,0.249689132
K82043,9730,8125,8008,7904,5822,4613,7516,2214,0.227543679
K82044,10526,8189,8104,7991,5782,2628,9468,1058,0.100513015
K82045,6644,5447,5379,5317,3824,2999,5138,1506,0.22667068
K82046,17843,14295,14070,13878,10130,7412,14265,3578,0.200526817
K82047,21918,17791,17537,17300,12803,9532,17125,4793,0.218678712
K82048,6866,5607,5524,5456,4005,2872,5486,1380,0.200990387
K82049,12614,10554,10384,10223,7080,6160,9276,3338,0.264626605
K82050,6751,4672,4554,4441,3130,1455,6107,644,0.095393275
K82051,12012,9889,9721,9571,6821,5537,9215,2797,0.232850483
K82053,12956,10536,10391,10243,7145,4178,10980,1976,0.152516209
K82054,11063,8543,8388,8247,6190,3388,9574,1489,0.134592787
K82055,10280,8421,8347,8257,5984,4162,8312,1968,0.191439689
K82057,8457,6971,6872,6768,4943,3996,6446,2011,0.237791179
K82058,5553,4384,4315,4253,3124,1913,4652,901,0.162254637
K82059,7567,5988,5905,5816,4262,2469,6439,1128,0.149068323
K82060,3827,3134,3091,3049,2320,1276,3339,488,0.127515025
K82061,4155,3417,3376,3335,2485,1898,3216,939,0.22599278
K82064,7193,5619,5539,5457,4010,1556,6684,509,0.070763242
K82065,19117,15654,15493,15298,11417,4650,17297,1820,0.095203222
K82066,13852,11435,11290,11150,8162,6262,10645,3207,0.231518914
K82067,17256,13548,13314,13134,10133,5291,15277,1979,0.114684747
K82068,5299,4314,4232,4148,3107,2246,4375,924,0.174372523
K82070,5477,4564,4486,4418,3330,2528,4339,1138,0.207777981
K82073,29882,24173,23814,23524,17190,12828,23446,6436,0.215380497
K82074,4549,3904,3864,3810,2760,1854,3861,688,0.151242031
K82076,13131,10364,10179,9981,7728,4299,11657,1474,0.112253446
K82078,8990,7434,7298,7169,4988,4077,7038,1952,0.217130145
K82079,8125,6690,6604,6503,4854,3764,6357,1768,0.2176
K82603,8760,6774,6668,6570,4788,2360,7824,936,0.106849315
K82610,8100,6091,5979,5869,4359,1840,7555,545,0.067283951
K82615,11170,8978,8838,8692,6629,3526,10141,1029,0.092121755
K82617,7532,5999,5926,5856,4529,2590,6351,1181,0.156797663
K82618,3627,2881,2842,2795,2118,1529,2991,636,0.17535153
K82621,5677,4406,4325,4241,3253,2032,4859,818,0.144090188
K82631,14396,10676,10400,10180,8278,3482,13321,1075,0.07467352
K82633,14791,10894,10633,10404,8033,3084,13899,892,0.060306943
K83002,49266,39550,39002,38482,28404,17059,41937,7329,0.148763853
K83003,9188,7510,7430,7343,5281,3376,7632,1556,0.169351328
K83005,13556,10581,10412,10258,7279,4297,11688,1868,0.137798761
K83006,10567,8478,8329,8189,6006,3988,8618,1949,0.184442131
K83007,12380,9850,9700,9581,7143,4590,10146,2234,0.180452342
K83008,8890,7267,7174,7099,5149,3809,6809,2081,0.23408324
K83009,12365,10879,10796,10689,5361,3904,10347,2018,0.163202588
K83010,18320,14341,14131,13944,10237,5739,15797,2523,0.137718341
K83011,11934,9842,9718,9576,6964,4984,9411,2523,0.21141277
K83012,11985,9714,9595,9464,6973,4225,9993,1992,0.16620776
K83013,13936,11213,11084,10936,7910,4557,11872,2064,0.148105626
K83014,17997,14604,14384,14144,10067,5540,15567,2430,0.135022504
K83015,12529,10391,10257,10132,7382,5188,9872,2657,0.212068002
K83017,8022,6693,6599,6520,4944,3881,6106,1916,0.238843181
K83018,11660,9471,9346,9221,6809,4615,9521,2139,0.183447684
K83019,6161,5132,5055,4986,3709,2885,4737,1424,0.23113131
K83020,3510,2703,2655,2599,1890,938,3170,340,0.096866097
K83021,20728,16757,16506,16290,11949,8412,16406,4322,0.208510228
K83022,9579,7907,7801,7702,5697,3815,7891,1688,0.176218812
K83023,11003,8961,8681,8403,6042,5147,8338,2665,0.242206671
K83024,11038,8924,8780,8656,6258,4270,8959,2079,0.188349339
K83025,15876,12621,12481,12353,9087,4304,14145,1731,0.109032502
K83026,19554,15681,15455,15260,10842,6040,16804,2750,0.140636187
K83027,10087,8273,8179,8093,5612,2949,8822,1265,0.125408942
K83028,11490,9328,9175,9049,6574,4626,9256,2234,0.194429939
K83029,12795,10419,10259,10111,7432,4438,10683,2112,0.165064478
K83030,9985,8197,8083,7986,5841,4337,7805,2180,0.218327491
K83031,8277,6871,6788,6706,5036,3736,6558,1719,0.207683943
K83032,21502,17496,17290,17041,12352,7798,17966,3536,0.164449819
K83035,6064,4963,4890,4835,3419,2043,5071,993,0.163753298
K83036,15033,12027,11866,11685,8421,5648,12324,2709,0.180203552
K83037,14224,11341,11171,11020,8005,5459,11496,2728,0.191788526
K83039,11015,9245,9120,9000,6271,4898,8452,2563,0.232682705
K83040,10427,8152,8032,7911,5806,3414,8785,1642,0.157475784
K83041,21866,16966,16748,16517,12089,7420,18055,3811,0.17428885
K83042,13994,10992,10825,10669,7636,4625,11708,2286,0.163355724
K83043,14603,11727,11556,11410,8171,5220,12307,2296,0.157227967
K83044,13033,10770,10630,10514,7289,5547,10205,2828,0.216987647
K83047,17571,14053,13845,13660,9892,6406,14423,3148,0.179158841
K83048,6532,5145,5045,4968,3708,2379,5419,1113,0.170391917
K83049,14150,11854,11688,11541,8430,6035,11542,2608,0.184310954
K83050,4740,3979,3950,3910,2710,1483,4059,681,0.143670886
K83051,19353,15573,15362,15170,10762,6489,16311,3042,0.157184933
K83052,21495,17135,16889,16649,12508,7985,17714,3781,0.175901372
K83053,5733,4736,4687,4626,3453,2636,4451,1282,0.223617652
K83055,7032,5548,5423,5310,3895,2603,5937,1095,0.155716724
K83056,4286,3597,3553,3515,2601,1412,3682,604,0.140923938
K83059,11650,9122,8995,8876,6364,3499,10257,1393,0.119570815
K83064,16473,13454,13255,13046,9612,7071,13242,3231,0.196139137
K83065,6552,5427,5350,5266,3965,2941,5186,1366,0.208485958
K83066,13671,11405,11262,11128,8247,6497,10263,3408,0.249286811
K83068,6101,5118,5045,4982,3752,3007,4701,1400,0.229470579
K83069,2524,2103,2078,2054,1478,1160,1854,670,0.265451664
K83070,10870,8815,8661,8523,6281,4225,8933,1937,0.178196872
K83076,8070,6394,6279,6190,4528,2293,7074,996,0.123420074
K83077,9854,8153,8032,7928,5498,3750,8048,1806,0.183275827
K83079,5363,4451,4391,4339,3274,2332,4264,1099,0.204922618
K83080,6022,4785,4705,4636,3400,2100,4967,1055,0.175190966
K83081,1350,1131,1123,1115,845,577,1090,260,0.192592593
K83601,9466,7834,7709,7594,5745,3844,7768,1698,0.179378829
K83607,2028,1699,1677,1661,1238,896,1617,411,0.202662722
K83610,9511,7525,7425,7329,5473,3038,8243,1268,0.133319314
K83614,5464,4319,4252,4205,3083,2034,4550,914,0.16727672
K83616,5326,4321,4266,4194,3106,2073,4378,948,0.177994743
K83618,11189,8522,8376,8223,6013,2786,10109,1080,0.096523371
K83620,8763,7188,7098,6996,5357,3642,7065,1698,0.193769257
K83621,12585,10304,10218,10130,6763,1598,12206,379,0.030115217
K83622,13530,10301,10155,9992,7692,3602,12154,1376,0.101699926
K83625,5510,4161,4079,4014,3228,1793,4825,685,0.124319419
K84001,10545,8765,8620,8464,6084,4554,8321,2224,0.210905642
K84002,18433,14806,14614,14427,10438,6177,15782,2651,0.143818152
K84003,5976,5004,4941,4874,3625,2861,4637,1339,0.224062918
K84004,13367,10885,10732,10581,7746,4349,11402,1965,0.147003815
K84006,14296,11887,11715,11553,8247,6765,10785,3511,0.245593173
K84007,8128,6862,6780,6708,4662,2785,6746,1382,0.170029528
K84008,7158,5951,5869,5778,4264,3338,5563,1595,0.222827605
K84009,29722,25375,24403,22741,11969,5490,27424,2298,0.077316466
K84010,8701,7250,7159,7084,5086,4043,6599,2102,0.241581427
K84011,17816,14733,14472,14178,8197,4850,15590,2226,0.124943871
K84012,7293,5600,5525,5450,4059,2869,5937,1356,0.185931715
K84013,23882,21564,21425,21288,8465,3200,22659,1223,0.051210116
K84014,11066,9280,9157,9031,6448,4714,8788,2278,0.205855774
K84015,4093,3483,3441,3402,2484,2078,3048,1045,0.255313951
K84016,16178,15177,15110,15045,6452,2946,14850,1328,0.082086785
K84017,18442,15248,15051,14856,10430,7173,14764,3678,0.19943607
K84019,15491,12729,12568,12394,8866,6721,12041,3450,0.222709961
K84020,9857,8172,8046,7929,5721,4580,7567,2290,0.232322208
K84021,9312,8299,8124,7914,3668,2076,8252,1060,0.113831615
K84023,4984,4087,4045,3986,2754,2147,3920,1064,0.213483146
K84024,8428,6799,6720,6625,4693,3255,6756,1672,0.198386331
K84025,15626,12866,12699,12552,8641,6237,12377,3249,0.207922693
K84026,11550,10081,9964,9850,6304,3512,10090,1460,0.126406926
K84027,17237,14337,14114,13909,9817,7479,13328,3909,0.226779602
K84028,25958,20773,20446,20115,14270,7718,22327,3631,0.139879806
K84030,15730,13060,12895,12702,8948,7127,11926,3804,0.241830896
K84031,10763,8347,8208,8084,5720,3108,9588,1175,0.109170306
K84032,8760,7140,7048,6947,5092,2368,7804,956,0.10913242
K84033,15128,12239,12062,11905,8580,6082,12193,2935,0.194011105
K84034,3319,2781,2734,2691,2057,1641,2564,755,0.227478156
K84035,9002,7585,7485,7379,5225,4039,6921,2081,0.231170851
K84036,5448,4361,4314,4254,3030,2359,4199,1249,0.229258443
K84037,17220,13878,13690,13510,9880,6958,13737,3483,0.202264808
K84038,15376,12637,12500,12367,9075,5773,12702,2674,0.173907388
K84040,14037,11718,11572,11434,8077,5672,11305,2732,0.194628482
K84041,12100,9992,9834,9711,7069,5279,9410,2690,0.22231405
K84042,9079,7627,7518,7427,5290,4320,6813,2266,0.249586959
K84043,15024,12011,11883,11755,8440,5032,12616,2408,0.16027689
K84044,17843,14681,14523,14311,10047,5373,15249,2594,0.14537914
K84045,7244,6138,6060,5983,4129,3032,5688,1556,0.214798454
K84046,5994,5015,4941,4878,3579,2989,4412,1582,0.263930597
K84047,6629,5602,5522,5453,3981,3287,4945,1684,0.254035299
K84048,9160,7471,7372,7275,5112,2452,8109,1051,0.114737991
K84049,7356,6671,6632,6590,3213,1522,6662,694,0.094344753
K84050,12449,10194,10044,9925,7200,5244,9812,2637,0.211824243
K84051,16095,13010,12834,12682,9302,6716,12821,3274,0.20341721
K84052,15202,12375,12228,12094,8979,5177,12842,2360,0.155242731
K84054,17352,13968,13803,13641,9835,5410,14688,2664,0.153526971
K84055,12084,9800,9640,9506,7155,5317,9441,2643,0.218718967
K84056,4110,3477,3439,3399,2549,2216,2985,1125,0.273722628
K84058,7961,6542,6462,6375,4672,3709,6078,1883,0.236528074
K84059,11445,9311,9156,9041,6693,4542,9315,2130,0.186107471
K84060,5225,4626,4581,4545,2644,1268,4626,599,0.114641148
K84062,7464,5872,5780,5676,4180,2161,6674,790,0.105841372
K84063,10329,8591,8502,8379,5584,1969,9612,717,0.069416207
K84065,2834,2392,2344,2288,1733,1405,2198,636,0.224417784
K84066,486,486,486,486,431,158,472,14,0.028806584
K84071,10000,8144,7993,7840,5632,4653,7508,2492,0.2492
K84072,11956,10064,9919,9817,6844,5413,9005,2951,0.246821679
K84075,11188,8406,8265,8146,5997,3275,9971,1217,0.108777261
K84078,9352,8785,8759,8719,3338,1227,8794,558,0.059666382
K84079,9607,7511,7266,7030,5294,3422,8262,1345,0.140002082
K84080,5596,5169,5137,5110,2501,1222,5009,587,0.104896355
K84082,13094,10743,10624,10514,7736,5111,10585,2509,0.19161448
K84605,5824,5509,5483,5443,2256,692,5502,322,0.055288462
K84610,5486,4646,4595,4530,3116,2372,4286,1200,0.218738607
K84613,20401,15907,15653,15397,11707,6236,18217,2184,0.107053576
K84618,7456,5941,5839,5728,4274,2752,6328,1128,0.151287554
K84624,10406,7839,7722,7615,6011,2530,9551,855,0.082164136
L81004,18851,15513,15341,15171,10935,8552,13962,4889,0.259349637
L81007,37724,31616,31349,31135,22141,9779,33367,4357,0.115496766
L81008,11205,8944,8833,8710,6259,3855,9379,1826,0.162962963
L81009,10164,8267,8160,8066,5537,3980,8045,2119,0.208480913
L81010,6625,5331,5253,5160,3685,2568,5443,1182,0.178415094
L81012,21890,18814,18641,18466,12805,4326,20587,1303,0.059524897
L81013,13437,10962,10823,10708,7678,4627,11205,2232,0.166108506
L81014,14495,12011,11834,11675,7994,6612,11004,3491,0.24084167
L81015,17003,13549,13333,13141,9531,4303,15616,1387,0.08157384
L81016,12068,10426,10323,10236,7179,5362,9340,2728,0.22605237
L81017,10998,8537,8416,8310,6283,4064,8824,2174,0.197672304
L81018,8480,7213,7118,7030,4820,4306,5929,2551,0.300825472
L81019,14927,12180,12041,11883,8651,5154,12605,2322,0.155557044
L81020,6737,5692,5628,5555,4044,2681,5507,1230,0.182573846
L81021,9661,8036,7880,7752,5418,4730,6950,2711,0.280612773
L81022,17914,14549,14356,14185,9637,4615,15830,2084,0.116333594
L81023,10490,8459,8345,8251,6086,2196,9747,743,0.070829361
L81024,14636,11918,11741,11581,8141,5868,11654,2982,0.203744192
L81025,12714,10484,10369,10234,7070,5783,9510,3204,0.252005663
L81026,26450,21419,21131,20843,14622,10112,21195,5255,0.198676749
L81027,6581,5361,5277,5180,3759,2914,5061,1520,0.230967938
L81029,9531,7881,7785,7681,5536,4429,7325,2206,0.231455251
L81030,6876,5676,5594,5516,4099,3065,5464,1412,0.205351949
L81031,16722,13648,13470,13302,9422,6708,13311,3411,0.203982777
L81033,15445,12613,12478,12330,9257,4898,13268,2177,0.140951764
L81034,32762,27094,26712,26325,18837,15210,24412,8350,0.254868445
L81036,10216,8191,8103,8001,5607,3452,8585,1631,0.159651527
L81037,20863,16550,16336,16125,11618,6362,17934,2929,0.140392082
L81038,13281,11019,10906,10801,7760,4476,11167,2114,0.159174761
L81039,27011,22943,22627,22293,15305,10797,21772,5239,0.193958017
L81040,16250,13561,13393,13240,9360,7469,12174,4076,0.250830769
L81041,6800,4996,4909,4830,3290,1875,6102,698,0.102647059
L81042,11670,9617,9501,9378,6727,4716,9642,2028,0.17377892
L81043,7894,6552,6483,6418,4516,3419,5987,1907,0.24157588
L81044,10846,9149,9037,8939,6253,5025,8128,2718,0.250599299
L81045,10860,9212,9120,9037,6226,5030,7956,2904,0.267403315
L81046,9668,7932,7828,7718,5406,4135,7436,2232,0.230864708
L81047,13783,11304,11142,10990,7524,5787,10721,3062,0.222157731
L81050,7075,5925,5861,5791,4279,3079,5655,1420,0.200706714
L81051,12474,10742,10648,10551,7283,5556,9446,3028,0.242744909
L81053,8466,6970,6884,6800,4742,3122,6913,1553,0.183439641
L81054,11219,8622,8486,8371,5971,3436,9728,1491,0.132899545
L81055,11906,9821,9674,9563,6774,4472,9717,2189,0.183856879
L81058,9052,7685,7600,7513,5255,4283,6723,2329,0.257291206
L81059,8981,7194,7091,7004,5075,3611,7137,1844,0.205322347
L81061,9839,7721,7654,7576,5514,1956,9061,778,0.079073077
L81062,22931,18542,18323,18134,13172,6997,19827,3104,0.13536261
L81063,12583,10340,10234,10112,6844,4516,10186,2397,0.190495112
L81064,7570,6142,6075,6005,4160,3163,5743,1827,0.241347424
L81065,10302,8237,8060,7888,5481,4076,8230,2072,0.201125995
L81066,11517,8954,8807,8679,6401,3584,9961,1556,0.135104628
L81067,11197,8917,8759,8566,5797,3542,9429,1768,0.157899437
L81068,11292,9701,9600,9494,6765,5072,8670,2622,0.232199787
L81069,7342,5840,5758,5675,3936,2389,6236,1106,0.150640153
L81070,7780,6381,6287,6201,4410,3207,6149,1631,0.209640103
L81071,13111,11709,11619,11496,5199,3471,11578,1533,0.11692472
L81072,9613,7965,7855,7759,5609,4520,7264,2349,0.2443566
L81073,7236,5924,5850,5755,4017,2973,5735,1501,0.207435047
L81075,23763,22033,21948,21844,5877,3092,22238,1525,0.064175399
L81077,7245,5855,5776,5692,3967,2833,5644,1601,0.220979986
L81078,20430,16249,16042,15859,11479,5499,18142,2288,0.111992168
L81079,22146,18241,18001,17781,12497,9235,17257,4889,0.220762214
L81081,16816,14473,14278,14091,9547,4775,14726,2090,0.124286394
L81082,12397,10341,10253,10174,7119,3123,11164,1233,0.099459547
L81083,7740,5820,5720,5605,3863,2368,6708,1032,0.133333333
L81084,11217,9150,9037,8909,6527,4122,9228,1989,0.177320139
L81085,6717,5671,5604,5528,3858,3171,4983,1734,0.25815096
L81086,44722,36521,36036,35583,25737,19137,34780,9942,0.222306695
L81087,11314,9271,9128,9012,6437,3640,9707,1607,0.142036415
L81089,9805,7544,7434,7348,5214,2540,8675,1130,0.115247323
L81090,16322,14033,13892,13768,9633,4329,14431,1891,0.1158559
L81091,16876,15042,14878,14762,10668,5805,14209,2667,0.158035079
L81094,6674,5122,5016,4895,3435,1866,5911,763,0.114324243
L81095,6864,5022,4933,4841,3494,1729,6196,668,0.097319347
L81098,8906,7052,6961,6860,4759,2850,7496,1410,0.158320234
L81101,6478,5362,5299,5224,3668,2849,5046,1432,0.221055881
L81103,8170,6730,6650,6564,4488,3526,6259,1911,0.233904529
L81106,5360,4429,4365,4303,3024,2362,4101,1259,0.23488806
L81117,4405,3649,3605,3567,2581,1892,3502,903,0.204994325
L81118,16906,13674,13516,13348,9326,5462,14459,2447,0.144741512
L81120,8409,6872,6803,6738,4912,2292,7409,1000,0.118920205
L81122,5218,4371,4314,4254,3090,2550,3833,1385,0.265427367
L81123,6470,5280,5186,5099,3688,2585,5266,1204,0.186089645
L81125,9054,7528,7453,7400,5489,2374,8108,946,0.104484206
L81127,5611,4517,4450,4381,3154,2187,4568,1043,0.185884869
L81130,11659,9470,9339,9218,6544,4324,9840,1819,0.156016811
L81131,10815,8597,8476,8339,5966,4462,8501,2314,0.21396209
L81132,4966,3844,3784,3725,2673,1600,4302,664,0.133709223
L81133,21794,21720,21718,21690,697,13,21792,2,9.18E-05
L81600,9921,7814,7692,7589,5817,3443,8394,1527,0.153915936
L81617,15430,15337,15332,15321,1134,236,15359,71,0.004601426
L81622,4808,3799,3744,3702,2872,1646,4096,712,0.148086522
L81632,11681,8793,8664,8516,6428,3083,10540,1141,0.097679993
L81637,3197,2680,2654,2625,1875,1227,2582,615,0.192367845
L81642,3203,2688,2659,2628,1882,1415,2507,696,0.217296285
L81643,15476,12827,12660,12489,8739,6859,11759,3717,0.240178341
L81644,7706,6147,6067,6001,4124,2462,6535,1171,0.151959512
L81648,5203,4163,4105,4048,2993,1081,4769,434,0.083413415
L81649,17845,13885,13668,13472,10307,4087,16640,1205,0.067525918
L81655,4327,3823,3797,3776,2394,1263,3767,560,0.129419921
L81669,7802,6674,6611,6517,4214,1977,6933,869,0.111381697
L81670,5587,4062,3981,3897,2713,1382,5041,546,0.097726866
L82001,19335,16084,15901,15708,10957,7123,15778,3557,0.183966899
L82003,8755,7364,7251,7170,5053,4510,6144,2611,0.298229583
L82004,7481,6346,6272,6192,4348,3722,5375,2106,0.281513167
L82006,20406,18035,17889,17758,8745,6363,17028,3378,0.165539547
L82007,3553,2911,2886,2851,2120,1749,2614,939,0.264283704
L82008,10802,9012,8890,8763,6212,5315,7790,3012,0.278837252
L82009,11845,9726,9616,9497,6838,5063,9245,2600,0.2195019
L82010,10850,8798,8670,8544,6037,4503,8605,2245,0.206912442
L82011,5337,4320,4253,4191,3015,2260,4207,1130,0.211729436
L82012,16237,13912,13779,13605,9756,8806,11477,4760,0.293157603
L82013,7657,6372,6277,6205,4625,3549,5680,1977,0.258195116
L82015,6282,5217,5162,5108,3747,3018,4604,1678,0.267112385
L82016,16207,13613,13450,13287,9633,7955,11970,4237,0.261430246
L82017,2408,2095,2078,2066,1395,1009,1849,559,0.232142857
L82018,13772,11241,11104,10958,7847,6227,10480,3292,0.239035725
L82021,6472,5557,5486,5414,3864,3349,4668,1804,0.278739184
L82022,9623,8445,8375,8277,5939,5717,6379,3244,0.33710901
L82023,16693,13613,13438,13288,9726,7188,12914,3779,0.226382316
L82024,4660,3918,3876,3844,2833,2049,3610,1050,0.225321888
L82025,5173,4519,4476,4420,3158,2969,3489,1684,0.325536439
L82026,6469,5492,5426,5353,3774,3203,4675,1794,0.277322616
L82028,16011,13366,13184,12983,9164,6772,12450,3561,0.222409593
L82029,14563,12262,12135,11995,8689,5949,11463,3100,0.212868228
L82030,18658,15409,15210,15016,10781,8400,14386,4272,0.228963447
L82035,8045,6871,6788,6711,4759,4247,5646,2399,0.298197638
L82036,11494,9397,9276,9155,6570,5090,8738,2756,0.239777275
L82038,4845,4175,4141,4102,3047,2702,3341,1504,0.310423117
L82039,5042,4331,4283,4239,3067,2791,3506,1536,0.304641015
L82041,30408,24400,24069,23744,17060,11913,24530,5878,0.193304394
L82042,11912,9986,9864,9742,6838,5377,9098,2814,0.236232371
L82043,4440,3849,3805,3746,2811,2479,3148,1292,0.290990991
L82044,8515,7136,7049,6981,4705,4124,6131,2384,0.279976512
L82045,9063,7696,7567,7468,5397,4541,6656,2407,0.265585347
L82046,12481,10305,10151,10023,7213,5702,9482,2999,0.240285234
L82047,7030,6102,6028,5955,4292,4012,4763,2267,0.322475107
L82048,3695,3243,3205,3167,2259,2138,2409,1286,0.348037889
L82049,9108,7658,7575,7492,5154,3839,7071,2037,0.223649539
L82050,9327,7745,7638,7535,5407,4380,7044,2283,0.244773239
L82051,13046,10515,10382,10259,7584,5239,10542,2504,0.191936226
L82052,10613,8989,8897,8803,6022,4782,7897,2716,0.25591256
L82054,8304,6779,6696,6632,4962,3726,6291,2013,0.242413295
L82056,8105,6808,6714,6637,4814,4333,5602,2503,0.308821715
L82057,2909,2519,2489,2467,1766,1674,1945,964,0.331385356
L82058,4848,4222,4182,4141,3073,2728,3403,1445,0.298061056
L82059,6022,4901,4831,4774,3411,2829,4562,1460,0.242444371
L82061,5703,4953,4890,4830,3349,3338,3646,2057,0.360687358
L82066,6890,5834,5775,5712,4177,3474,4978,1912,0.277503628
L82068,7472,6211,6135,6074,4541,3454,5718,1754,0.234743041
L82070,5905,5010,4965,4895,3419,3036,4204,1701,0.288060965
L82618,3013,2487,2454,2430,1739,1476,2205,808,0.268171258
L82620,5650,4731,4671,4614,3373,2671,4312,1338,0.236814159
L82622,7669,6755,6685,6628,3890,2918,6153,1516,0.197678967
L83002,17227,14507,14348,14210,9786,8399,12426,4801,0.278690428
L83003,9788,7975,7848,7742,5454,3761,8060,1728,0.176542705
L83004,11139,9284,9159,9053,6369,5012,8532,2607,0.234042553
L83005,14291,12286,12145,12012,8506,7578,9977,4314,0.301868309
L83006,39769,32204,31747,31283,22214,15847,32045,7724,0.19422163
L83007,8305,7220,7148,7071,4703,5017,5100,3205,0.385912101
L83008,18347,14793,14603,14423,10047,6781,14955,3392,0.184880362
L83010,6611,5511,5418,5341,3933,3200,4983,1628,0.24625624
L83011,8288,7271,7191,7096,4663,5023,4954,3334,0.40226834
L83012,2862,2435,2401,2363,1738,1526,2046,816,0.285115304
L83013,15824,13271,13130,12955,8981,7401,11724,4100,0.259100101
L83014,22977,19593,19386,19154,13419,12066,16072,6905,0.300517909
L83015,7327,5696,5592,5500,3862,2602,6116,1211,0.165279105
L83016,39891,36548,36382,36140,12125,7996,35710,4181,0.104810609
L83018,12707,11135,11049,10974,5680,2639,11495,1212,0.095380499
L83019,7066,5877,5799,5722,3788,2799,5443,1623,0.22969148
L83020,12114,10369,10265,10136,6956,6466,8250,3864,0.318969787
L83021,10187,8489,8384,8293,5720,5033,7225,2962,0.290762737
L83022,9229,7947,7870,7773,5417,4830,6379,2850,0.308809188
L83023,5118,4328,4250,4202,3032,2731,3701,1417,0.276865963
L83024,7848,6681,6614,6539,4703,2989,6342,1506,0.191896024
L83025,6961,5962,5894,5831,4189,3856,4847,2114,0.303691998
L83026,5212,4416,4369,4321,3083,2682,3731,1481,0.284151957
L83027,8155,6866,6730,6583,4699,3229,6642,1513,0.185530349
L83028,11514,9261,9116,8980,6445,4277,9599,1915,0.166319264
L83029,7508,6115,6021,5944,4149,3044,5946,1562,0.208044752
L83030,8185,7062,6996,6916,4734,2944,6858,1327,0.16212584
L83031,11403,9555,9438,9330,6631,5761,8231,3172,0.278172411
L83034,10500,8772,8671,8563,5973,4514,8158,2342,0.223047619
L83035,15722,13035,12861,12688,9071,7202,12041,3681,0.234130518
L83036,10937,9068,8963,8845,6290,5072,8062,2875,0.26286916
L83038,12451,10532,10355,10163,7366,6481,8963,3488,0.280138142
L83039,5864,4522,4463,4388,3047,1998,4897,967,0.164904502
L83040,13366,10667,10505,10376,7416,4906,10906,2460,0.18404908
L83041,8861,7305,7211,7130,5178,3969,6778,2083,0.235075048
L83042,9233,7704,7613,7543,5572,3218,7706,1527,0.165385032
L83043,15232,12965,12805,12619,9225,7453,11344,3888,0.255252101
L83044,7772,6580,6515,6441,4670,4162,5531,2241,0.288342769
L83045,14531,12190,12030,11906,8403,7337,10448,4083,0.280985479
L83046,9003,7392,7288,7199,5155,3741,7103,1900,0.211040764
L83048,10882,8967,8859,8786,6066,4971,8069,2813,0.258500276
L83049,3176,2817,2779,2762,1985,1808,2193,983,0.309508816
L83050,12469,10696,10563,10442,7443,6642,8607,3862,0.309728126
L83051,10445,8874,8755,8654,6087,4782,8020,2425,0.232168502
L83052,14744,12131,11960,11789,8313,6387,11428,3316,0.224905046
L83053,12057,10191,10077,9962,6755,6007,8581,3476,0.288297255
L83054,5905,5323,5274,5238,3489,3755,3471,2434,0.412193057
L83055,12843,11204,11072,10974,7634,7491,8440,4403,0.342832671
L83056,11185,9359,9239,9124,6381,5392,8139,3046,0.272329012
L83057,7161,6154,6079,6022,4070,4001,4786,2375,0.33165759
L83058,8334,7140,7077,7008,4906,2977,6837,1497,0.17962563
L83059,10054,8474,8356,8245,5780,5057,7302,2752,0.273721902
L83064,12058,9871,9729,9580,6518,5660,8859,3199,0.265301045
L83065,7019,5867,5780,5700,4101,3344,5201,1818,0.259011255
L83066,16656,13831,13677,13527,9390,5824,13766,2890,0.173511047
L83067,14427,12818,12677,12554,7914,9125,8331,6096,0.422541069
L83068,2524,2267,2254,2239,1612,1412,1811,713,0.282488114
L83069,14740,12557,12409,12272,8789,7767,10633,4107,0.278629579
L83070,4833,4063,4016,3959,2894,2300,3657,1176,0.243327126
L83071,7814,6467,6399,6319,4584,3072,6477,1337,0.171103148
L83072,10913,9145,9044,8942,6264,3990,9060,1853,0.169797489
L83073,17527,14468,14301,14144,9873,7413,13567,3960,0.225937126
L83075,5757,4843,4759,4692,3449,2883,4308,1449,0.25169359
L83076,8928,7341,7258,7190,5108,3349,7396,1532,0.171594982
L83077,7868,6565,6496,6439,4060,2484,6688,1180,0.149974581
L83079,7827,6607,6528,6448,4568,3613,5915,1912,0.244282611
L83081,6197,5203,5143,5072,3580,3258,4320,1877,0.302888494
L83082,3006,2612,2577,2560,1880,1691,2085,921,0.306387226
L83083,15359,12746,12578,12399,8670,7047,11588,3771,0.245523797
L83084,7636,6319,6241,6167,4348,3194,6063,1573,0.205997905
L83085,16119,13422,13196,12990,9025,7379,12073,4046,0.251008127
L83086,4590,3882,3849,3804,2848,2494,3267,1323,0.288235294
L83087,14520,11975,11810,11666,8276,6681,10869,3651,0.251446281
L83088,4824,4156,4123,4074,2879,2644,3267,1557,0.322761194
L83089,12661,10200,10050,9910,7050,5193,10100,2561,0.202274702
L83092,15809,12765,12598,12422,8999,6790,12379,3430,0.21696502
L83094,7717,6731,6668,6589,4665,4434,5124,2593,0.336011403
L83095,16506,13737,13541,13361,9559,8463,11797,4709,0.285290198
L83096,18453,15520,15322,15126,10946,8863,13770,4683,0.253779873
L83097,12617,10163,10025,9892,7034,5701,9463,3154,0.249980185
L83098,5088,4300,4260,4211,3159,2665,3643,1445,0.284001572
L83099,5835,4988,4943,4893,3416,2084,4755,1080,0.185089974
L83100,43077,35375,34860,34402,24699,18589,33767,9310,0.216124614
L83101,14437,12338,12187,12055,8646,7727,10214,4223,0.292512295
L83102,7581,6459,6372,6302,4587,4211,5323,2258,0.297849888
L83103,16262,13731,13568,13405,9257,7877,11911,4351,0.267556266
L83105,6873,5851,5775,5716,4109,3579,4968,1905,0.277171541
L83106,8822,7333,7253,7160,5105,4138,6603,2219,0.251530265
L83111,13739,11612,11477,11357,7854,6578,10093,3646,0.265375937
L83112,5387,4839,4810,4787,3380,2452,4112,1275,0.236680898
L83113,7343,5655,5572,5501,3955,2403,6289,1054,0.143538063
L83115,4292,3326,3272,3223,2250,1486,3524,768,0.178937558
L83116,4398,3686,3648,3596,2651,2172,3285,1113,0.253069577
L83118,19746,15927,15678,15452,11038,7856,15901,3845,0.194722982
L83120,8740,7441,7358,7264,5316,4697,6067,2673,0.30583524
L83127,9257,7508,7390,7296,5194,3980,7197,2060,0.222534298
L83128,7189,5959,5880,5797,4177,3033,5735,1454,0.202253443
L83129,2715,2327,2304,2284,1659,1481,1900,815,0.300184162
L83131,26193,22304,22094,21826,15353,13032,18922,7271,0.27759325
L83134,3661,3119,3083,3045,2150,1889,2627,1034,0.282436493
L83136,6087,5228,5170,5115,3593,2972,4396,1691,0.277805159
L83137,11824,9927,9784,9629,6803,5906,8632,3192,0.269959405
L83143,4229,3402,3360,3320,2466,1435,3587,642,0.151808938
L83146,3658,3111,3068,3037,2259,1780,2723,935,0.255604155
L83147,11244,9573,9446,9313,6524,3942,9598,1646,0.146389185
L83148,3775,3268,3233,3200,2262,2271,2367,1408,0.372980132
L83607,5067,3996,3902,3846,2742,1977,4144,923,0.182159068
L83616,2026,1664,1636,1608,1149,938,1522,504,0.248766041
L83624,7684,6091,6007,5935,4226,2463,6590,1094,0.142373764
L83627,3941,3265,3225,3192,2275,1889,2940,1001,0.253996448
L83628,5103,4342,4304,4263,3023,2383,3807,1296,0.253968254
L83639,2686,2317,2294,2271,1622,1529,1765,921,0.342889054
L83642,3306,2776,2738,2702,2028,1564,2439,867,0.262250454
L83646,7743,6171,6084,6004,4419,2617,6729,1014,0.130956993
L83648,20552,18231,18105,17958,6912,3864,18877,1675,0.081500584
L83651,4015,3226,3197,3150,2242,1117,3575,440,0.109589041
L83655,6235,4846,4774,4686,3270,1574,5679,556,0.089174018
L83657,4600,3957,3908,3860,2763,2537,3169,1431,0.311086957
L83663,2940,2550,2513,2473,1738,1664,1999,941,0.320068027
L83666,3653,2864,2823,2785,1947,1291,3044,609,0.166712291
L83673,549,548,548,547,423,139,533,16,0.029143898
L84001,8597,6497,6370,6259,4472,2482,7627,970,0.112830057
L84003,11290,9970,9918,9846,4295,2539,10005,1285,0.113817538
L84004,7703,6416,6341,6277,4531,3952,5418,2285,0.296637674
L84005,7643,6449,6360,6275,4461,4145,5264,2379,0.31126521
L84006,6887,6106,5928,5611,3174,2766,5493,1394,0.202410338
L84007,12027,9907,9761,9605,7095,4990,9687,2340,0.194562235
L84008,10217,8403,8294,8198,5907,3867,8272,1945,0.190368993
L84009,18564,14965,14750,14558,10698,7084,15337,3227,0.173831071
L84010,12436,10541,10396,10257,7334,6189,9169,3267,0.26270505
L84011,7453,6232,6169,6081,4207,3536,5585,1868,0.250637327
L84012,22649,19036,18793,18513,12700,9703,17746,4903,0.216477549
L84014,9009,7579,7481,7388,5037,4465,6450,2559,0.284049284
L84015,10949,8808,8637,8506,6197,4844,8462,2487,0.227144031
L84016,6905,5728,5629,5536,3978,3222,5282,1623,0.235047067
L84018,13224,11206,11077,10931,7744,6008,10022,3202,0.242135511
L84021,8059,6634,6544,6458,4721,3786,6153,1906,0.23650577
L84022,8796,7395,7301,7224,5290,3601,7068,1728,0.196452933
L84023,13140,11002,10852,10732,7627,5895,10084,3056,0.232572298
L84024,4290,3631,3579,3546,2550,2121,3181,1109,0.258508159
L84025,4782,4126,4064,4019,2787,2696,3207,1575,0.3293601
L84026,29448,24085,23737,23429,16441,11710,23708,5740,0.194919859
L84027,6550,5516,5442,5362,3844,3178,4883,1667,0.254503817
L84028,7774,6375,6286,6201,4466,3337,6022,1752,0.225366607
L84029,3318,2831,2795,2764,2037,1622,2521,797,0.240204943
L84030,9141,7516,7333,7150,4963,2739,7895,1246,0.136308938
L84031,5483,4738,4680,4632,3242,2942,3818,1665,0.303665876
L84032,9700,8202,8103,8008,5753,4509,7440,2260,0.232989691
L84033,13338,10801,10664,10521,7586,5316,10760,2578,0.193282351
L84034,13384,10652,10486,10329,7461,4638,11295,2089,0.156081889
L84036,11114,9001,8866,8759,6141,4828,8484,2630,0.236638474
L84037,10981,9306,9205,9104,6397,5545,7840,3141,0.286039523
L84038,11321,9332,9195,9088,6565,5369,8463,2858,0.252451197
L84039,8711,7225,7121,7023,5124,3683,6929,1782,0.204568936
L84040,13379,11093,10957,10812,7794,6419,9902,3477,0.259884894
L84041,12464,10165,9914,9612,6705,4650,10288,2176,0.174582798
L84043,5037,4318,4273,4216,2954,2766,3484,1553,0.308318444
L84044,5036,4229,4179,4140,3024,2323,3859,1177,0.233717236
L84045,6316,5288,5214,5153,3688,3069,4650,1666,0.263774541
L84046,6430,5365,5307,5246,3680,2888,4926,1504,0.233903577
L84047,13988,11360,11212,11059,7749,5960,10899,3089,0.220832142
L84048,10704,8713,8606,8508,5921,4787,7954,2750,0.256913303
L84049,6789,5575,5504,5453,3883,2445,5577,1212,0.178524083
L84050,25959,19948,19646,19354,14034,8073,22638,3321,0.127932509
L84051,8948,7359,7239,7112,5210,3856,7129,1819,0.20328565
L84052,8008,6496,6402,6302,4374,2599,6901,1107,0.138236763
L84053,7667,6358,6270,6197,4457,3768,5639,2028,0.264510239
L84054,13283,10887,10710,10566,7817,5542,10533,2750,0.207031544
L84056,8289,6826,6748,6652,4699,3148,6769,1520,0.183375558
L84058,9410,7737,7622,7525,5245,3440,7684,1726,0.183421892
L84059,7871,6753,6700,6636,4539,2762,6464,1407,0.178757464
L84060,10613,8969,8854,8751,6254,5125,7978,2635,0.248280411
L84063,4446,3692,3620,3557,2727,2083,3510,936,0.210526316
L84065,9013,7537,7443,7350,5411,4218,6898,2115,0.234661045
L84067,9043,7226,7125,7049,5093,3504,7398,1645,0.181908659
L84068,4632,3932,3892,3863,2738,2385,3286,1346,0.290587219
L84069,7068,6074,5990,5931,4081,3701,5061,2007,0.283955857
L84070,6046,4893,4833,4776,3557,2484,4795,1251,0.206913662
L84071,6180,5176,5111,5052,3717,3035,4625,1555,0.251618123
L84072,4854,4164,4118,4082,2911,2421,3600,1254,0.258343634
L84073,4244,3431,3387,3337,2434,1674,3436,808,0.190386428
L84075,4980,4095,4039,3988,2818,2151,3856,1124,0.225702811
L84077,4788,4026,3969,3923,2794,2216,3710,1078,0.225146199
L84078,5227,4313,4249,4206,3186,2503,4024,1203,0.230151138
L84080,4328,3629,3528,3437,2387,1866,3412,916,0.211645102
L84081,4583,3739,3697,3649,2520,1634,3806,777,0.169539603
L84084,9842,7763,7649,7545,5434,3510,8145,1697,0.172424304
L84085,3929,3251,3208,3166,2232,1763,2933,996,0.253499618
L84606,12336,10694,10587,10467,6699,5748,9283,3053,0.24748703
L84613,3028,2501,2462,2426,1662,1343,2315,713,0.235468956
L84615,3331,2845,2811,2775,1955,1697,2475,856,0.256979886
L84616,5108,4361,4319,4270,3105,2012,4231,877,0.171691464
L84617,6055,4668,4592,4525,3442,1705,5454,601,0.099256813
L85001,16065,13209,12982,12727,9110,6479,12653,3412,0.212387177
L85002,11460,9716,9536,9375,6414,5854,8159,3301,0.288045375
L85003,3860,3441,3413,3386,2426,2380,2533,1327,0.343782383
L85004,12931,11014,10899,10769,7509,6723,9023,3908,0.302219473
L85006,10177,8274,8156,8045,5964,3958,8373,1804,0.177262455
L85007,10590,9050,8933,8854,6233,5771,7234,3356,0.316902738
L85008,29267,23968,23626,23330,16972,11902,23366,5901,0.201626405
L85009,10218,8819,8731,8645,5982,5750,6712,3506,0.343119984
L85010,12080,10165,10022,9896,6900,5863,8805,3275,0.271109272
L85011,7981,6732,6628,6533,4570,3989,5803,2178,0.272898133
L85012,15214,12645,12482,12312,8658,6978,11395,3819,0.251018798
L85013,3676,3133,3111,3075,2211,1959,2611,1065,0.289717084
L85014,13594,10974,10828,10702,7757,4675,11487,2107,0.154994851
L85015,12765,10548,10392,10252,7114,5423,9930,2835,0.222091657
L85016,16453,14226,14079,13943,9671,8982,11169,5284,0.321157236
L85017,9849,8304,8193,8102,5509,4353,7403,2446,0.248350086
L85018,5198,4437,4363,4300,2945,2603,3776,1422,0.273566756
L85019,13264,11585,11464,11370,7359,6995,8937,4327,0.326221351
L85020,10679,8712,8592,8475,6283,5066,7943,2736,0.256203764
L85021,13129,10902,10691,10500,7076,6300,9440,3689,0.280981034
L85022,14901,12157,12012,11876,8491,6122,11768,3133,0.210254345
L85023,16920,13756,13545,13354,9213,5810,13971,2949,0.17429078
L85024,9701,8299,8191,8089,5893,5072,7030,2671,0.27533244
L85025,11282,9009,8914,8812,6153,3907,9377,1905,0.16885304
L85026,5604,4687,4615,4553,3316,2761,4165,1439,0.256780871
L85027,8899,7269,7181,7095,5026,3891,6813,2086,0.23440836
L85028,5687,4802,4757,4688,3227,2870,4002,1685,0.296289784
L85029,13062,10810,10657,10497,7375,5804,9937,3125,0.239243607
L85030,8428,7118,7036,6954,4895,4031,6191,2237,0.265424775
L85031,7036,5921,5861,5793,4171,3660,4916,2120,0.301307561
L85032,6003,4912,4744,4565,3043,2512,4809,1194,0.19890055
L85033,13167,11214,11083,10957,7766,7050,9183,3984,0.302574618
L85034,7878,6696,6619,6551,4726,4030,5672,2206,0.28002031
L85035,15203,12413,12243,12071,8537,5906,12280,2923,0.192264685
L85036,5630,4678,4596,4537,3339,2716,4162,1468,0.260746004
L85037,4003,3355,3310,3271,2415,2091,2820,1183,0.295528354
L85038,6617,5648,5569,5493,3934,3598,4705,1912,0.288952698
L85039,13798,11398,11047,10648,7499,5984,10725,3073,0.222713437
L85040,5584,4690,4623,4564,3235,2763,4075,1509,0.27023639
L85042,13888,11384,11217,11062,7748,5468,11247,2641,0.190164171
L85043,11304,9279,9169,9057,6528,4786,8996,2308,0.204175513
L85044,5962,5068,5004,4941,3487,3347,4113,1849,0.310130829
L85046,5503,4521,4462,4410,3255,2536,4230,1273,0.231328366
L85047,6158,5272,5193,5121,3920,2861,4921,1237,0.200876908
L85048,5838,4644,4572,4495,3309,2214,4759,1079,0.18482357
L85050,6590,5482,5384,5279,3748,3067,4916,1674,0.254021244
L85051,6440,5194,5117,5050,3621,2341,5359,1081,0.167857143
L85052,7478,6475,6374,6266,4296,3554,5570,1908,0.255148435
L85053,6430,5407,5345,5271,3765,2849,5038,1392,0.216485226
L85054,7495,6285,6202,6124,4333,3774,5363,2132,0.284456304
L85055,8531,7184,7074,6953,5059,4343,6338,2193,0.257062478
L85056,6456,5288,5224,5161,3800,2852,5039,1417,0.21948575
L85061,3778,3145,3116,3082,2191,1755,2883,895,0.23689783
L85062,6115,4920,4854,4780,3478,2342,5001,1114,0.18217498
L85064,10707,8286,8184,8083,5712,2484,9785,922,0.086111889
L85065,6494,5739,5698,5649,4045,4014,4169,2325,0.35802279
L85066,7178,5901,5824,5756,4012,3474,5303,1875,0.261214823
L85601,2916,2518,2492,2456,1757,1586,2094,822,0.281893004
L85607,4352,3295,3248,3195,2414,1324,3844,508,0.116727941
L85609,4415,3496,3450,3406,2474,1881,3387,1028,0.232842582
L85611,2981,2380,2297,2210,1604,1147,2449,532,0.178463603
L85612,5000,3842,3769,3719,2694,1521,4347,653,0.1306
L85619,7163,5916,5835,5757,4072,3121,5581,1582,0.220857183
L85624,2748,2378,2353,2333,1647,1623,1766,982,0.357350801
M81001,10545,8634,8516,8392,5962,4146,8463,2082,0.197439545
M81002,14763,12107,11984,11847,8559,5313,12166,2597,0.175912755
M81003,8870,7435,7327,7259,5040,4078,6616,2254,0.254114994
M81004,15256,12773,12635,12491,8969,6402,11973,3283,0.215194022
M81005,13795,11120,10967,10810,7766,5292,11173,2622,0.190068866
M81006,20338,16670,16411,16191,11337,7650,16802,3536,0.173861737
M81007,5556,4700,4638,4578,3361,2928,4051,1505,0.27087833
M81008,16794,14010,13839,13683,9380,5940,13866,2928,0.174347981
M81009,5839,4906,4845,4790,3420,3120,4134,1705,0.292002055
M81010,13474,11008,10870,10742,7602,5319,10798,2676,0.19860472
M81011,4807,4101,4057,4008,2930,2467,3542,1265,0.263157895
M81012,8555,7348,7264,7178,5098,4350,6097,2458,0.287317358
M81015,9822,8121,8030,7933,5696,4371,7431,2391,0.243433109
M81016,10118,8476,8394,8309,5846,4800,7468,2650,0.261909468
M81017,11953,9221,9064,8927,6404,3802,10380,1573,0.131598762
M81018,6282,5402,5337,5293,3818,3647,4174,2108,0.335561923
M81019,17440,13886,13691,13520,10164,6119,14199,3241,0.185837156
M81020,12332,9905,9783,9647,6878,4275,10249,2083,0.168910152
M81021,13070,10641,10470,10324,7607,5324,10479,2591,0.198240245
M81022,16869,13638,13451,13243,9605,6398,13873,2996,0.177603889
M81024,5074,4326,4275,4236,3074,2743,3620,1454,0.286558928
M81025,5655,4690,4634,4580,3301,2362,4524,1131,0.2
M81026,48097,39342,38854,38348,27235,19076,38742,9355,0.194502776
M81027,8440,6762,6668,6541,4609,3639,6475,1965,0.232819905
M81029,7819,6873,6813,6743,4684,4577,5116,2703,0.345696381
M81032,12199,10101,9963,9823,6898,5299,9514,2685,0.220100008
M81033,7031,5880,5789,5709,4228,3543,5333,1698,0.24150192
M81034,8901,7428,7321,7241,5087,4071,6634,2267,0.254690484
M81035,12421,9998,9863,9714,7155,4613,10222,2199,0.177038886
M81037,11307,9530,9423,9318,6707,4794,8885,2422,0.214203591
M81038,11380,9854,9739,9630,6810,6359,7880,3500,0.307557118
M81039,10276,8696,8589,8495,6034,5009,7497,2779,0.270435967
M81040,11667,9899,9773,9682,6673,5952,8299,3368,0.288677466
M81041,9858,8083,7966,7872,5679,4002,7831,2027,0.205619801
M81042,9410,8047,7945,7858,5564,5132,6482,2928,0.311158342
M81043,8736,7472,7368,7278,5211,4782,6005,2731,0.312614469
M81044,10725,9046,8938,8829,6410,5103,8001,2724,0.253986014
M81045,4677,3990,3946,3906,2888,2546,3335,1342,0.28693607
M81046,10923,9322,9200,9100,6343,5839,7665,3258,0.298269706
M81047,9914,8162,8057,7942,5653,4047,7666,2248,0.22675005
M81048,9443,8205,8124,8037,5788,5086,6587,2856,0.302446256
M81049,11556,9435,9321,9225,6840,4531,9362,2194,0.189858082
M81054,7153,6199,6128,6052,4219,3967,4886,2267,0.316929959
M81055,5523,4403,4340,4280,3093,2069,4519,1004,0.181785262
M81056,13968,11712,11584,11437,8033,6031,10809,3159,0.226159794
M81057,15568,13502,13357,13207,9542,8603,10612,4956,0.318345324
M81058,10167,8504,8384,8311,5839,4678,7634,2533,0.249139372
M81061,8567,7467,7379,7286,5055,4545,5929,2638,0.307925762
M81062,3820,3028,2986,2934,2165,1363,3134,686,0.179581152
M81063,12192,10155,10038,9917,6895,5350,9255,2937,0.240895669
M81064,7129,5796,5726,5661,3939,3249,5311,1818,0.255014729
M81066,8862,7491,7394,7324,5188,3999,6796,2066,0.233130219
M81067,4713,3879,3823,3774,2716,2264,3480,1233,0.261616805
M81068,14384,12055,11923,11771,8377,6591,10798,3586,0.249304783
M81069,8858,7538,7450,7377,5063,4318,6472,2386,0.26936103
M81070,12876,10443,10193,9919,6819,5271,10160,2716,0.210935073
M81072,7118,6092,6008,5932,4307,3039,5694,1424,0.200056196
M81073,9550,7976,7885,7787,5488,4504,6976,2574,0.269528796
M81074,10491,8983,8864,8764,6149,5591,7318,3173,0.302449719
M81075,13954,11711,11516,11328,7864,6646,10337,3617,0.259208829
M81076,3085,2637,2604,2580,1857,1731,2132,953,0.3089141
M81077,4804,4116,4059,4008,2888,2476,3477,1327,0.276228143
M81078,6800,5690,5606,5530,4028,3306,5188,1612,0.237058824
M81081,4693,3948,3899,3851,2682,2319,3430,1263,0.269124228
M81082,14479,11643,11501,11351,8375,5327,12087,2392,0.165204779
M81083,4455,3876,3832,3801,2498,2375,3091,1364,0.30617284
M81084,5380,4369,4317,4264,3209,2253,4283,1097,0.203903346
M81089,6522,5113,5051,4981,3742,2151,5453,1069,0.163906777
M81090,3540,3058,3020,2982,2149,1925,2520,1020,0.288135593
M81091,13176,10843,10687,10541,7563,5932,10236,2940,0.223132969
M81092,5665,4714,4642,4592,3387,2372,4571,1094,0.193115622
M81093,8530,6803,6705,6606,4704,2927,7187,1343,0.157444314
M81094,9694,7941,7851,7754,5674,3665,7896,1798,0.185475552
M81600,3306,2854,2825,2794,2066,1839,2374,932,0.281911676
M81604,5769,4853,4778,4720,3403,2940,4208,1561,0.270584157
M81605,4914,4034,3969,3917,2875,2214,3887,1027,0.208994709
M81608,3219,2750,2728,2696,1929,1685,2352,867,0.269338304
M81616,2823,2295,2274,2246,1663,1132,2334,489,0.173219979
M81617,5477,4316,4260,4207,3164,1874,4716,761,0.138944678
M81621,4997,4249,4208,4148,2868,2594,3521,1476,0.295377226
M81627,7875,6398,6309,6234,4540,2603,6673,1202,0.152634921
M81629,9793,8199,8007,7783,5150,4304,7416,2377,0.242724395
M82002,10822,8880,8664,8383,5799,4476,8547,2275,0.210219922
M82003,24059,18811,18549,18267,13170,8221,20235,3824,0.158942599
M82004,16339,14017,13849,13695,9695,8430,11644,4695,0.287349287
M82005,9027,7533,7417,7326,5172,4177,6765,2262,0.250581589
M82006,10698,9257,9172,9090,6295,4708,8149,2549,0.238268835
M82007,15650,12554,12391,12240,8883,5962,12741,2909,0.185878594
M82008,7368,6567,6489,6417,4321,4606,4594,2774,0.376492942
M82009,9980,8222,8105,8014,5621,4115,7902,2078,0.208216433
M82010,17762,14584,14406,14211,10047,7883,13624,4138,0.23296926
M82011,4281,3585,3530,3481,2522,2067,3190,1091,0.254846998
M82012,14371,11158,11014,10878,7820,4776,12156,2215,0.154129845
M82013,2822,2498,2464,2435,1716,1563,2002,820,0.290574061
M82014,8520,7342,7267,7187,4864,4491,5869,2651,0.311150235
M82016,9895,8357,8251,8148,5714,4848,7196,2699,0.272764022
M82017,4787,4100,4055,4010,2887,2538,3452,1335,0.278880301
M82018,6542,5426,5364,5296,3727,3041,4869,1673,0.255732192
M82019,8149,7004,6825,6581,4746,4221,5828,2321,0.284820223
M82020,3558,3059,3023,2988,2166,1908,2573,985,0.276840922
M82021,8106,7054,6979,6913,4645,4608,5423,2683,0.330989391
M82022,13540,11314,11169,11029,7979,5815,10573,2967,0.219128508
M82023,7000,5728,5610,5494,4009,3148,5523,1477,0.211
M82024,3564,3057,3012,2986,2169,1916,2580,984,0.276094276
M82025,16118,13628,13402,13162,9348,7727,12088,4030,0.250031021
M82026,12957,10810,10657,10497,7348,5884,9910,3047,0.23516246
M82028,15526,12952,12772,12588,9016,7377,11637,3889,0.250483061
M82030,8068,6734,6653,6567,4660,3940,5926,2142,0.265493307
M82031,3188,2682,2649,2621,1855,1580,2293,895,0.280740276
M82032,17041,13504,13295,13117,9337,5878,14293,2748,0.161258142
M82033,5389,4668,4604,4546,3271,3017,3713,1676,0.311003897
M82034,7837,6743,6669,6595,4761,3706,5993,1844,0.235294118
M82035,11613,9735,9587,9446,6680,5432,8811,2802,0.241281323
M82038,11147,9103,8968,8849,6511,4643,8904,2243,0.201220059
M82039,14674,12195,12010,11863,8249,5814,11630,3044,0.207441734
M82040,6153,5059,4968,4888,3595,2475,5066,1087,0.176661791
M82041,7131,6041,5979,5918,4214,3716,5190,1941,0.272191838
M82042,6528,4907,4807,4734,3216,2008,5580,948,0.145220588
M82043,7677,6569,6488,6424,4463,4018,5395,2282,0.297251531
M82044,5030,4218,4157,4092,2831,2443,3657,1373,0.272962227
M82046,4051,3354,3316,3280,2287,1978,2932,1119,0.276228092
M82047,8865,7365,7292,7208,5158,3940,6869,1996,0.225155104
M82048,6047,4952,4891,4821,3434,2597,4686,1361,0.225070283
M82051,4684,3911,3864,3827,2865,2337,3445,1239,0.264517506
M82056,13955,12009,11883,11746,7170,5232,11435,2520,0.180580437
M82057,6381,5026,4956,4886,3745,1779,5682,699,0.109543959
M82058,3460,3025,2989,2960,2124,1902,2496,964,0.278612717
M82059,13233,11090,10922,10761,7801,6076,10551,2682,0.20267513
M82060,8360,7004,6912,6823,4862,3693,6491,1869,0.223564593
M82601,2313,2013,1990,1970,1375,1326,1480,833,0.360138348
M82604,2001,1751,1721,1696,1252,1104,1438,563,0.28135932
M82606,4773,3991,3942,3901,3130,2114,3907,866,0.181437251
M82616,6487,5247,5173,5090,3654,2468,5359,1128,0.173886234
M82620,3039,2674,2645,2617,1916,1835,1980,1059,0.348469891
M83001,11957,9790,9663,9553,6853,4925,9568,2389,0.199799281
M83004,10521,9046,8949,8862,6351,5354,7675,2846,0.270506606
M83005,5226,4427,4368,4322,3107,2318,4014,1212,0.231917336
M83006,29105,24322,24030,23746,17125,13144,21941,7164,0.246143274
M83007,7397,6026,5950,5858,4262,2732,6160,1237,0.167229958
M83009,10670,9151,9055,8962,6305,5675,7553,3117,0.29212746
M83010,10736,8146,8015,7896,5489,2955,9412,1324,0.123323398
M83011,8063,6865,6780,6702,4763,3993,5872,2191,0.271735086
M83012,8022,6705,6623,6531,4640,3695,6054,1968,0.245325355
M83013,4738,4123,4056,4014,2881,2727,3262,1476,0.31152385
M83014,9348,7355,7241,7139,5127,3014,7939,1409,0.150727428
M83015,7188,6069,5988,5925,4290,3509,5328,1860,0.258764608
M83016,7341,6248,6178,6112,4407,3544,5513,1828,0.249012396
M83017,4310,3732,3689,3657,2710,2310,3079,1231,0.285614849
M83018,7998,6736,6660,6576,4621,3910,5941,2057,0.257189297
M83020,10117,8384,8273,8160,5892,4561,7755,2362,0.233468419
M83021,9925,7948,7833,7725,5595,3552,8242,1683,0.169571788
M83022,8233,7084,6997,6921,5066,4401,5838,2395,0.290902466
M83023,9134,7764,7679,7578,5406,4272,6863,2271,0.248631487
M83024,7253,6018,5938,5858,4244,3065,5771,1482,0.204329243
M83025,6421,5637,5582,5530,3917,3085,4873,1548,0.241083943
M83026,15317,11712,11532,11360,8013,4107,13533,1784,0.116471894
M83027,10984,8970,8846,8716,6441,4248,9092,1892,0.172250546
M83028,12193,9830,9694,9584,6929,4359,10184,2009,0.164766669
M83030,11837,9686,9541,9421,6754,4832,9368,2469,0.208583256
M83031,6591,5617,5555,5493,3805,3387,4628,1963,0.297830375
M83032,13374,11120,10969,10832,7716,5558,10665,2709,0.202557201
M83033,2591,2179,2165,2139,1584,1059,2065,526,0.203010421
M83034,12363,10203,10051,9928,6966,5012,9733,2630,0.212731538
M83035,6107,5059,4987,4915,3613,2927,4637,1470,0.240707385
M83036,9088,7386,7298,7209,5064,3686,7254,1834,0.201804577
M83037,7985,6572,6500,6430,4690,3549,6185,1800,0.225422668
M83038,10567,8703,8582,8496,5898,4839,8032,2535,0.239897795
M83041,5560,4769,4717,4670,3269,3010,3874,1686,0.30323741
M83042,9860,8413,8319,8224,5795,4923,7359,2501,0.253651116
M83044,12143,10039,9924,9807,6832,4434,10019,2124,0.174915589
M83045,9936,8422,8314,8220,5864,4821,7258,2678,0.26952496
M83046,9768,8287,8206,8117,5787,4770,7183,2585,0.26463964
M83047,6580,5397,5345,5278,3800,2792,5213,1367,0.20775076
M83048,9969,8180,8070,7950,5839,4043,7941,2028,0.203430635
M83049,10808,8986,8871,8771,6253,4730,8330,2478,0.229274611
M83050,10399,8649,8545,8457,5999,4226,8258,2141,0.205885181
M83051,11330,9388,9275,9177,6487,4482,9183,2147,0.189496911
M83052,19977,16012,15799,15602,11339,7181,16362,3615,0.180958102
M83054,10072,8428,8316,8232,6028,4380,7943,2129,0.211378078
M83056,11371,9530,9404,9301,6652,4864,8795,2576,0.226541201
M83057,10649,8778,8682,8565,6077,4132,8559,2090,0.19626256
M83059,3932,3355,3305,3259,2395,2006,2870,1062,0.270091556
M83061,8244,6850,6755,6682,4658,3741,6160,2084,0.252789908
M83062,12789,10668,10530,10404,7366,5609,9848,2941,0.22996325
M83063,3462,2789,2743,2705,1988,1304,2858,604,0.174465627
M83065,7157,5910,5834,5749,4273,3413,5403,1754,0.245074752
M83066,7455,6072,6004,5934,4291,2675,6192,1263,0.169416499
M83067,7996,6679,6594,6520,4689,3030,6626,1370,0.171335668
M83068,14692,11514,11308,11111,7954,5124,12326,2366,0.161040022
M83069,14631,12217,12058,11940,8588,6755,11115,3516,0.240311667
M83070,8099,7006,6942,6866,4998,3953,6050,2049,0.252994197
M83071,12466,10475,10331,10204,7351,5807,9478,2988,0.239691962
M83072,11573,9905,9803,9683,6685,5805,8318,3255,0.281258101
M83073,9711,8044,7937,7819,5583,4085,7696,2015,0.207496653
M83074,13935,11580,11414,11249,7951,5909,11187,2748,0.197201292
M83075,8795,6994,6911,6830,4782,2451,7682,1113,0.126549176
M83076,9219,8233,8176,8121,4102,2302,8178,1041,0.112918972
M83079,8925,7455,7363,7281,5209,4102,6795,2130,0.238655462
M83082,12916,10336,10189,10034,7170,4868,10570,2346,0.181635181
M83084,6731,5652,5579,5516,3853,3078,5089,1642,0.243945922
M83088,15512,13116,12957,12821,9038,6702,12058,3454,0.222666323
M83089,11065,9188,9078,8948,6393,5097,8295,2770,0.250338906
M83090,5243,4494,4436,4390,3085,2484,3869,1374,0.262063704
M83092,8125,6944,6875,6809,5030,4230,5887,2238,0.275446154
M83093,6661,5606,5544,5490,3697,3248,4976,1685,0.25296502
M83094,14474,11605,11446,11302,8029,5689,11642,2832,0.195661186
M83096,6088,5224,5164,5082,3621,2915,4577,1511,0.248193167
M83097,8197,6706,6618,6523,4625,3499,6435,1762,0.214956691
M83100,3836,3169,3133,3105,2058,1766,2811,1025,0.267205422
M83102,5619,4309,4236,4145,2951,1769,4864,755,0.134365545
M83103,4169,3553,3515,3482,2444,2097,2988,1181,0.283281362
M83107,6460,5318,5246,5156,3654,2627,5210,1250,0.193498452
M83108,7385,6141,6040,5981,4296,3321,5666,1719,0.232769127
M83109,3029,2539,2514,2490,1776,1273,2388,641,0.211620997
M83110,12143,9789,9662,9531,7010,4474,9875,2268,0.186774273
M83111,1705,1482,1461,1453,1070,782,1298,407,0.238709677
M83113,2311,1805,1777,1749,1319,743,2008,303,0.131112073
M83115,2237,1924,1898,1880,1313,1101,1622,615,0.27492177
M83117,4277,3518,3448,3400,2521,1666,3485,792,0.185176526
M83121,6097,5205,5154,5091,3690,3168,4356,1741,0.285550271
M83122,2997,2534,2503,2471,1834,1525,2295,702,0.234234234
M83123,7727,6164,6067,5985,4248,2712,6560,1167,0.15102886
M83125,3667,3155,3129,3092,2204,1911,2688,979,0.266975729
M83126,6888,5561,5486,5408,3765,2592,5633,1255,0.182200929
M83127,5755,4284,4212,4131,2942,1325,5202,553,0.096090356
M83129,10613,8571,8457,8359,6110,4080,8857,1756,0.165457458
M83130,3984,3395,3360,3320,2316,1868,3069,915,0.229668675
M83132,5795,4877,4821,4769,3554,2515,4591,1204,0.207765315
M83134,3461,2890,2855,2816,2016,1152,2996,465,0.134354233
M83138,6964,5736,5655,5603,4170,2991,5484,1480,0.212521539
M83139,4901,4073,4014,3958,2822,2025,3953,948,0.193429912
M83140,4543,3787,3736,3698,2533,1923,3539,1004,0.22099934
M83141,8803,7197,7119,7033,5020,3849,6731,2072,0.235374304
M83143,4713,3618,3556,3495,2514,1481,4087,626,0.132824104
M83146,15438,11979,11788,11612,8135,5213,12946,2492,0.161419873
M83148,14423,11497,11333,11155,8125,4962,12161,2262,0.156832836
M83601,5691,4901,4864,4804,3356,3087,3809,1882,0.330697593
M83608,5281,4461,4418,4352,2960,2458,4048,1233,0.233478508
M83616,5414,4518,4447,4381,3062,2169,4432,982,0.181381603
M83617,17340,14393,14192,14026,9881,7887,13179,4161,0.239965398
M83619,3138,2675,2657,2627,1852,1198,2586,552,0.175908222
M83623,4295,3395,3352,3300,2316,1040,3855,440,0.102444703
M83624,2801,2299,2270,2245,1617,1139,2216,585,0.208853981
M83625,7312,5889,5826,5776,4148,2599,6052,1260,0.172319475
M83627,6754,5239,5153,5084,3458,1856,5817,937,0.138732603
M83632,4497,3672,3625,3574,2624,1960,3485,1012,0.225038915
M83637,3934,3155,3104,3055,2161,1436,3264,670,0.170310117
M83638,14164,11565,11405,11261,8177,5575,11663,2501,0.176574414
M83640,2596,2213,2184,2161,1597,1362,1892,704,0.271186441
M83641,2173,1783,1745,1698,1180,934,1699,474,0.218131615
M83650,12061,8998,8856,8728,6192,3379,10537,1524,0.126357682
M83661,5469,4327,4275,4211,3069,1857,4682,787,0.143901993
M83668,4552,3742,3706,3656,2678,1894,3663,889,0.19529877
M83670,8018,7721,7712,7696,1192,655,7719,299,0.037291095
M83680,5876,4851,4783,4718,3290,2435,4707,1169,0.19894486
M83681,8899,6904,6805,6704,4852,2046,8034,865,0.097201933
M83682,6035,4904,4830,4772,3435,2213,5067,968,0.16039768
M83691,1917,1687,1669,1650,1172,1068,1353,564,0.294209703
M83693,6584,5031,4939,4852,3640,1886,5909,675,0.102521264
M83697,2759,2182,2147,2119,1486,951,2276,483,0.175063429
M83698,3201,2712,2681,2646,1808,1437,2442,759,0.237113402
M83700,4990,3651,3587,3514,2235,622,4798,192,0.038476954
M83701,4119,3419,3367,3331,2345,1737,3212,907,0.220199077
M83703,4671,3762,3699,3660,2659,1866,3800,871,0.186469707
M83705,4545,3607,3556,3512,2689,1596,3867,678,0.149174917
M83706,1819,1427,1399,1375,974,588,1570,249,0.1368884
M83709,5611,4640,4576,4510,3387,2356,4557,1054,0.187845304
M83711,3565,2985,2965,2936,2128,1664,2635,930,0.260869565
M83713,4814,3878,3815,3766,2644,1965,3790,1024,0.212712921
M83715,4781,3885,3831,3786,2768,1877,4013,768,0.16063585
M83717,3256,2713,2661,2626,1863,1265,2665,591,0.181511057
M83718,3627,3008,2981,2967,2123,1211,3070,557,0.153570444
M83719,4337,3572,3538,3507,2581,1759,3569,768,0.177080932
M83722,3512,2879,2838,2802,2057,1364,2823,689,0.19618451
M83723,12042,9475,9323,9202,6593,4112,10203,1839,0.152715496
M83725,3236,2433,2391,2344,1694,974,2790,446,0.137824475
M83727,3917,3322,3287,3254,2382,1885,2890,1027,0.262190452
M83738,5894,4970,4896,4835,3325,2670,4463,1431,0.242789277
M84001,14929,12362,12186,12033,8504,6168,11802,3127,0.209458102
M84002,7538,6259,6172,6093,4240,3444,5745,1793,0.237861502
M84003,9173,7500,7425,7335,5259,3766,7329,1844,0.201024747
M84004,13875,11507,11367,11224,7867,5820,10803,3072,0.221405405
M84005,4690,3809,3758,3718,2674,1821,3859,831,0.177185501
M84006,10505,8802,8700,8583,6283,4790,8176,2329,0.22170395
M84007,12590,10378,10249,10119,7234,5361,9763,2827,0.224543288
M84008,10487,8353,8244,8115,6059,3843,8865,1622,0.154667684
M84009,5469,4637,4584,4533,3414,2781,4153,1316,0.240629
M84010,10120,8513,8433,8343,6035,3828,8173,1947,0.192391304
M84011,20471,16940,16744,16546,11612,8645,15939,4532,0.221386351
M84012,14055,11177,10989,10828,7750,4960,11811,2244,0.159658485
M84013,11989,10146,10000,9850,6888,5805,8829,3160,0.263574944
M84014,9421,8227,8123,8034,5613,4606,6862,2559,0.271627216
M84015,15445,12600,12434,12287,9156,4875,13212,2233,0.144577533
M84016,4387,3671,3635,3587,2530,2028,3268,1119,0.255071803
M84017,13671,11269,11127,11002,7967,5125,10917,2754,0.201448321
M84018,12643,10646,10510,10381,7642,6155,9504,3139,0.24827968
M84019,16397,13523,13353,13191,9444,6986,12871,3526,0.215039336
M84020,13852,11208,11066,10941,7898,5246,11265,2587,0.186760035
M84021,16096,13639,13497,13338,9404,7021,12348,3748,0.232852883
M84022,8739,7097,6996,6915,4988,3355,7113,1626,0.186062479
M84023,21427,16900,16637,16389,12392,6790,18559,2868,0.133849816
M84024,6640,5708,5644,5577,3864,3604,4602,2038,0.306927711
M84025,11336,9624,9521,9415,6721,5843,8093,3243,0.286079746
M84026,7997,6720,6627,6530,4610,3687,6095,1902,0.23783919
M84028,18007,15081,14915,14729,10842,7314,14295,3712,0.206142056
M84029,7247,5943,5845,5757,4069,3040,5695,1552,0.214157582
M84030,12064,10156,10026,9896,7029,5679,9060,3004,0.249005305
M84031,7453,5917,5724,5515,4005,2900,6115,1338,0.179525023
M84032,13243,11135,11050,10964,7514,3560,11559,1684,0.127161519
M84034,2688,2148,2127,2108,1568,1013,2197,491,0.18266369
M84035,11825,9426,9315,9192,6650,3805,10003,1822,0.154080338
M84036,14306,11875,11722,11568,8251,6451,10846,3460,0.241856564
M84037,11696,9707,9577,9456,6738,5235,8971,2725,0.232985636
M84040,9839,8627,8535,8441,5947,3787,8094,1745,0.177355422
M84041,5384,4492,4435,4379,3152,1995,4400,984,0.182763744
M84042,10251,8649,8567,8480,6057,4790,7848,2403,0.234416155
M84043,19350,16216,16019,15835,11458,8257,15170,4180,0.216020672
M84044,5856,4952,4885,4835,3493,2856,4344,1512,0.258196721
M84046,7872,6578,6483,6400,4388,3890,5655,2217,0.281631098
M84047,4674,4005,3975,3930,2783,2502,3331,1343,0.287334189
M84049,5600,4799,4748,4699,3287,2856,4067,1533,0.27375
M84050,8095,6482,6418,6333,4521,2574,7032,1063,0.131315627
M84051,12344,10004,9876,9754,6977,4363,10440,1904,0.154244977
M84055,2421,2130,2110,2083,1529,1162,1871,550,0.227178852
M84059,3854,3269,3235,3208,2339,1280,3216,638,0.165542294
M84060,6198,5198,5133,5073,3608,2916,4594,1604,0.258793159
M84061,5590,4718,4658,4614,3193,2780,4037,1553,0.277817531
M84062,5721,4654,4588,4536,3472,2278,4791,930,0.162558993
M84063,7114,5416,5343,5266,4015,2336,6029,1085,0.152516165
M84064,6449,5179,5123,5076,3732,2182,5450,999,0.154907738
M84065,6070,4958,4904,4852,3448,1755,5235,835,0.137561779
M84066,5136,4046,3985,3937,2909,2009,4070,1066,0.207554517
M84067,7881,6467,6380,6317,4500,3030,6366,1515,0.192234488
M84069,5265,4339,4279,4209,3195,2160,4330,935,0.177587844
M84070,8908,6914,6793,6679,4968,2476,7976,932,0.104625056
M84609,4279,3305,3260,3221,2340,1363,3658,621,0.145127366
M84612,3790,3130,3100,3065,2264,1461,3209,581,0.153298153
M84615,6207,5015,4943,4891,3488,2281,5130,1077,0.173513775
M84616,3993,3267,3201,3151,2371,1712,3239,754,0.188830453
M84618,3658,3005,2971,2923,2026,1500,2875,783,0.214051394
M84620,2673,2280,2255,2227,1643,1357,1989,684,0.255892256
M84621,2667,2130,2095,2060,1478,787,2322,345,0.12935883
M84627,4149,3470,3429,3390,2391,1974,3053,1096,0.264160039
M84629,6825,5492,5424,5367,3805,2460,5670,1155,0.169230769
M85001,4636,3617,3555,3507,2414,1533,3998,638,0.137618637
M85002,21758,18288,18048,17784,10887,4484,20113,1645,0.075604375
M85005,8454,6128,5994,5842,3879,1753,7783,671,0.079370712
M85006,8247,6316,6225,6133,4375,2636,7028,1219,0.147811325
M85007,9031,6950,6847,6761,4597,2587,7907,1124,0.124460193
M85008,2075,1605,1574,1551,1122,751,1726,349,0.168192771
M85009,6038,4855,4792,4728,3175,1994,5067,971,0.160814839
M85011,7427,5882,5788,5710,4055,2863,6042,1385,0.186481756
M85013,3539,2715,2656,2618,1843,1216,2991,548,0.154846002
M85014,2957,2341,2303,2267,1635,1001,2544,413,0.139668583
M85016,6290,5056,4989,4915,3450,2360,5191,1099,0.174721781
M85018,9231,7413,7319,7220,5015,3685,7361,1870,0.202578269
M85019,17607,13817,13582,13395,9444,5854,14886,2721,0.154540808
M85020,19420,13937,13605,13284,9113,3985,18029,1391,0.071627188
M85021,3146,2743,2712,2692,2021,789,2876,270,0.085823268
M85023,9774,7406,7259,7133,4916,3037,8332,1442,0.147534275
M85024,6765,4971,4869,4749,3202,1411,6239,526,0.077753141
M85025,12159,10685,10611,10526,6236,2024,11440,719,0.059133152
M85026,15836,13319,13165,12995,9480,7331,12102,3734,0.235791867
M85027,8440,6786,6691,6579,4657,3258,6917,1523,0.180450237
M85028,25572,20290,19982,19682,14294,8938,21108,4464,0.174565931
M85029,7835,6504,6432,6347,4567,3448,6038,1797,0.229355456
M85030,17458,13894,13698,13497,9476,6084,14715,2743,0.157119945
M85031,10742,8536,8420,8292,5731,3982,8808,1934,0.180040961
M85033,17560,14050,13871,13693,9951,6621,14289,3271,0.186275626
M85034,17413,11910,11538,11208,7461,3181,16252,1161,0.066674324
M85035,5372,4097,4027,3958,2850,1547,4690,682,0.126954579
M85037,9597,7784,7673,7570,5581,3749,7737,1860,0.193810566
M85041,11775,10946,10890,10841,3009,1190,11166,609,0.051719745
M85042,4995,4216,4169,4131,2888,1746,4123,872,0.174574575
M85043,4498,3430,3377,3317,2320,1517,3716,782,0.173855047
M85046,51794,42471,41841,41283,29137,22703,39734,12060,0.232845503
M85047,6098,4944,4860,4793,3473,2329,4965,1133,0.185798622
M85048,11277,9280,9150,9015,6298,4681,8898,2379,0.210960362
M85051,6160,4547,4450,4352,2930,1159,5715,445,0.07224026
M85053,6081,4436,4346,4244,2975,1412,5544,537,0.088307844
M85055,6608,5350,5300,5252,3181,1569,5871,737,0.111531477
M85056,7448,6120,6034,5960,4242,2858,6103,1345,0.180585392
M85058,12471,10071,9962,9848,6785,3208,11014,1457,0.116831048
M85060,12919,10522,10367,10212,7014,5001,10544,2375,0.183837758
M85061,10818,8087,7913,7734,5201,2952,9607,1211,0.111943058
M85062,5778,4531,4466,4392,3146,2180,4642,1136,0.196607823
M85063,63164,51328,50556,49805,35723,22357,53254,9910,0.156893167
M85064,1803,1623,1610,1597,1209,345,1732,71,0.039378813
M85065,12262,10006,9890,9784,6887,4579,10036,2226,0.181536454
M85066,7440,5604,5513,5399,3713,2314,6311,1129,0.151747312
M85069,17219,13029,12750,12498,8710,4098,15732,1487,0.086358093
M85070,12762,9960,9812,9693,6938,3538,11257,1505,0.117928224
M85071,8615,6976,6871,6768,5041,3372,7059,1556,0.180615206
M85074,8302,7022,6947,6862,5304,3130,6874,1428,0.172006745
M85076,8005,6202,6114,6024,4315,2813,6621,1384,0.172891943
M85077,9059,7429,7310,7226,5310,3934,6963,2096,0.231372116
M85078,11356,8511,8323,8099,5612,2641,10321,1035,0.091141247
M85079,8505,6680,6554,6441,4344,2792,7250,1255,0.147560259
M85081,10045,7804,7666,7555,5383,3377,8526,1519,0.151219512
M85082,3970,3204,3167,3118,2387,1027,3597,373,0.09395466
M85084,6252,4781,4701,4629,3090,1566,5596,656,0.104926424
M85085,1764,1289,1267,1240,869,311,1676,88,0.049886621
M85086,10365,8077,7947,7838,5530,3267,8916,1449,0.139797395
M85087,11302,8636,8487,8341,5889,3525,9768,1534,0.13572819
M85088,14755,12456,12317,12174,8530,3838,13183,1572,0.106540156
M85092,6609,5254,5156,5089,3577,2259,5692,917,0.138750189
M85094,1817,1415,1396,1380,955,498,1631,186,0.102366538
M85097,2140,1714,1693,1675,1175,744,1782,358,0.16728972
M85098,5092,4177,4122,4071,2874,1212,4607,485,0.095247447
M85105,4197,3333,3289,3237,2286,1370,3571,626,0.149154158
M85107,3055,2289,2231,2188,1520,814,2787,268,0.087725041
M85108,5388,3894,3776,3662,2413,1230,4893,495,0.091870824
M85110,11760,8688,8452,8238,5360,2427,10816,944,0.080272109
M85113,6382,4925,4840,4750,3296,2139,5348,1034,0.162018176
M85115,2384,1955,1932,1909,1447,984,1952,432,0.181208054
M85116,8484,6164,6025,5887,3936,1851,7695,789,0.092998586
M85117,5949,4643,4563,4506,3257,2084,4930,1019,0.171289292
M85118,3528,2832,2783,2751,1995,1343,2856,672,0.19047619
M85123,8229,5966,5819,5690,3756,1558,7586,643,0.078138291
M85124,10595,8521,8402,8277,5587,2515,9552,1043,0.098442662
M85128,5361,4146,4066,3978,2771,1433,4788,573,0.106883044
M85134,3055,2395,2357,2313,1724,1098,2543,512,0.167594108
M85136,10129,7447,7314,7186,4913,2649,9031,1098,0.108401619
M85139,5553,4075,3971,3875,2537,1012,5213,340,0.061228165
M85141,2949,2413,2375,2347,1609,1250,2295,654,0.221770092
M85142,1501,1245,1229,1212,833,654,1139,362,0.241172552
M85143,7509,6033,5946,5876,4104,2567,6291,1218,0.162205354
M85145,6980,5589,5497,5428,3786,2324,5923,1057,0.151432665
M85146,4958,3761,3674,3587,2411,947,4639,319,0.06434046
M85149,5596,4091,3981,3881,2624,1094,5151,445,0.079521086
M85153,2758,2098,2068,2024,1414,672,2483,275,0.099709935
M85154,4281,3102,3037,2967,2007,800,3943,338,0.078953516
M85155,5287,4123,4064,4002,2739,1787,4495,792,0.1498014
M85156,6821,5431,5348,5288,3822,2028,6038,783,0.114792552
M85158,2227,1798,1772,1745,1214,904,1785,442,0.198473282
M85159,8105,6461,6378,6302,4355,2941,6579,1526,0.18827884
M85164,10410,7758,7588,7414,5123,2252,9465,945,0.090778098
M85167,20725,20099,20058,20006,6836,1351,20109,616,0.029722557
M85170,4485,3406,3338,3286,2307,1047,4040,445,0.099219621
M85171,2678,2102,2080,2052,1476,906,2289,389,0.145257655
M85172,12454,9814,9662,9539,6905,4121,10499,1955,0.156977678
M85174,4933,3797,3738,3673,2601,1250,4494,439,0.088992499
M85175,11275,9584,9472,9370,6745,5485,8330,2945,0.261197339
M85176,4883,3794,3740,3678,2601,1315,4380,503,0.103010444
M85177,6477,5028,4942,4869,3398,2030,5560,917,0.141577891
M85178,10374,8212,8075,7944,5854,2751,9404,970,0.093502988
M85179,4630,3730,3681,3633,2520,1841,3738,892,0.192656587
M85600,12566,9997,9872,9746,7032,3685,10924,1642,0.130670062
M85624,6383,5083,4976,4897,3481,2127,5488,895,0.140216199
M85634,8122,6209,6076,5963,4227,2007,7367,755,0.0929574
M85642,5770,4458,4378,4293,3026,1578,5132,638,0.110571924
M85663,851,716,697,678,465,140,825,26,0.030552291
M85669,4814,3861,3809,3742,2677,1120,4481,333,0.069173245
M85670,2940,2125,2070,2020,1335,471,2795,145,0.049319728
M85671,2184,1849,1823,1807,1312,694,1851,333,0.152472527
M85676,5076,3839,3750,3670,2463,1045,4649,427,0.084121355
M85679,5605,4002,3893,3810,2523,1002,5187,418,0.074576271
M85680,2235,1533,1486,1448,1020,350,2131,104,0.046532438
M85684,2386,2030,2010,1993,1448,610,2175,211,0.088432523
M85686,1650,1253,1229,1205,865,433,1503,147,0.089090909
M85693,2054,1736,1710,1687,1184,740,1710,344,0.167478092
M85694,2521,2042,2008,1983,1405,880,2127,394,0.156287188
M85697,4524,3467,3406,3352,2363,1198,4094,430,0.09504863
M85699,5278,3982,3885,3796,2614,1008,4922,356,0.067449792
M85701,4120,2982,2902,2829,1890,684,3890,230,0.055825243
M85706,11466,8613,8420,8246,5758,2951,10235,1231,0.107360893
M85711,2111,1698,1669,1644,1082,457,1936,175,0.0828991
M85713,4200,3095,3027,2962,1966,851,3847,353,0.084047619
M85715,10927,7996,7809,7622,5260,2152,10158,769,0.070376133
M85716,4809,3770,3705,3656,2617,1128,4478,331,0.068829278
M85717,3813,2889,2833,2772,1874,1093,3348,465,0.12195122
M85721,9171,7496,7392,7299,5321,1720,8761,410,0.044706139
M85722,5554,4016,3884,3764,2489,921,5219,335,0.060316889
M85730,2788,2092,2058,2018,1467,713,2537,251,0.090028694
M85732,1814,1394,1372,1339,896,519,1630,184,0.101433297
M85733,3760,2987,2943,2896,2145,1129,3306,454,0.120744681
M85735,5893,4106,3993,3870,2561,880,5578,315,0.05345325
M85736,4932,3814,3756,3686,2670,1217,4473,459,0.093065693
M85739,5183,3723,3628,3538,2430,876,4925,258,0.049778121
M85746,5778,4174,4092,4016,2849,1462,5191,587,0.101592246
M85749,2667,1970,1917,1882,1283,528,2454,213,0.079865017
M85753,2278,1794,1767,1741,1242,685,2012,266,0.116769096
M85756,2984,2380,2327,2261,1600,768,2676,308,0.103217158
M85757,3409,2576,2530,2481,1723,659,3203,206,0.060428278
M85759,6321,4323,4212,4126,2886,1381,5809,512,0.080999842
M85766,3763,2714,2652,2596,1748,676,3499,264,0.07015679
M85770,2416,1996,1967,1940,1418,912,2025,391,0.161837748
M85774,5868,4129,4020,3909,2659,991,5515,353,0.060156783
M85778,11469,11101,11089,11079,4017,561,11330,139,0.012119627
M85779,2869,2240,2200,2170,1492,969,2465,404,0.140815615
M85781,3567,2547,2476,2411,1651,655,3360,207,0.05803196
M85782,3004,2791,2780,2757,909,363,2870,134,0.04460719
M85783,5111,3515,3414,3304,2111,765,4855,256,0.050088045
M85792,2848,2387,2358,2333,1662,1326,2133,715,0.251053371
M85794,2908,2148,2096,2035,1348,560,2707,201,0.06911967
M85797,8844,7647,7572,7522,4557,1497,8423,421,0.047602895
M85801,1272,1087,1062,1049,741,519,1056,216,0.169811321
M85803,10471,7152,6951,6730,4503,1298,10129,342,0.032661637
M86001,6259,4781,4713,4638,3320,1860,5457,802,0.128135485
M86002,7998,6425,6356,6276,4361,2772,6737,1261,0.157664416
M86003,16888,13049,12777,12538,8977,5321,14421,2467,0.146080057
M86004,18859,17248,17139,17035,5227,3419,17157,1702,0.090248688
M86005,3730,3028,2991,2960,2066,1316,3126,604,0.161930295
M86006,9683,8069,7961,7864,5560,3585,8039,1644,0.169782092
M86007,5929,5241,5184,5133,3398,3008,4298,1631,0.275088548
M86008,9744,7775,7665,7540,5350,3447,8189,1555,0.159585386
M86009,28200,26045,25944,25771,7210,3178,26821,1379,0.048900709
M86010,10582,8535,8415,8270,5680,3526,8792,1790,0.169155169
M86012,7590,5983,5890,5792,3880,1945,6762,828,0.109090909
M86014,19406,15418,15196,14962,10532,6446,16442,2964,0.152736267
M86015,13552,10820,10657,10528,7599,4604,11317,2235,0.164920307
M86016,13055,10353,10222,10075,7158,3733,11457,1598,0.122405209
M86017,9689,7882,7778,7696,5449,3294,8222,1467,0.151408814
M86018,11638,9288,9137,9003,6492,4122,9696,1942,0.166867159
M86019,4649,3919,3866,3827,2705,1956,3659,990,0.212949021
M86020,8647,6203,6066,5938,4307,2051,7917,730,0.084422343
M86021,6999,5666,5561,5482,3882,2685,5727,1272,0.181740249
M86023,5216,4235,4163,4114,2952,2020,4310,906,0.173696319
M86027,9896,8185,8095,8009,4526,2635,8529,1367,0.138136621
M86028,3387,2638,2594,2551,1870,995,2960,427,0.126070269
M86029,18744,17260,17189,17124,5330,3264,17007,1737,0.092669654
M86030,7142,5999,5934,5871,4138,2681,5781,1361,0.190562868
M86032,13016,10015,9851,9678,6818,3671,11440,1576,0.121081746
M86033,4198,3264,3211,3159,2280,1355,3647,551,0.131252978
M86034,10825,8723,8603,8492,5853,4192,8556,2269,0.20960739
M86035,7699,5985,5906,5811,4094,2449,6572,1127,0.146382647
M86037,3968,3227,3190,3157,2285,1361,3309,659,0.166078629
M86038,3014,2578,2547,2520,1765,1401,2215,799,0.265096218
M86039,4327,3652,3616,3577,2483,1947,3211,1116,0.257915415
M86040,5149,4095,4037,3996,2901,1733,4261,888,0.172460672
M86041,8071,6400,6326,6249,4395,2323,7047,1024,0.126873993
M86044,4067,3293,3248,3199,2446,1305,3583,484,0.119006639
M86045,7158,5634,5543,5430,3886,2168,6209,949,0.132578933
M86046,5201,4215,4169,4112,2922,1860,4342,859,0.165160546
M86048,7529,5697,5587,5475,3950,1796,6893,636,0.08447337
M86605,2883,2370,2342,2303,1621,1221,2242,641,0.222337843
M86610,2150,1778,1760,1737,1158,504,1962,188,0.08744186
M86612,2831,2226,2195,2174,1594,628,2600,231,0.081596609
M86617,2881,2326,2287,2263,1644,998,2395,486,0.168691427
M86622,2859,2481,2454,2421,1738,1191,2278,581,0.203217908
M86624,9514,7220,7077,6957,5030,2429,8591,923,0.097014925
M86627,6220,4512,4415,4350,3222,1095,5908,312,0.050160772
M86633,4941,3642,3549,3469,2470,969,4589,352,0.07124064
M86638,5715,4685,4625,4558,3254,2127,4810,905,0.158355206
M87001,7139,6115,6044,5981,4220,3496,5150,1989,0.27861045
M87003,14294,12152,11970,11825,8079,7090,10221,4073,0.284944732
M87005,9972,8153,8051,7960,5809,4151,7767,2205,0.221119134
M87006,7954,6518,6431,6344,4363,3023,6566,1388,0.174503395
M87007,11282,9396,9280,9181,6177,4908,8672,2610,0.231341961
M87008,7680,6473,6387,6310,4497,3494,5856,1824,0.2375
M87009,17187,13844,13674,13493,9774,6536,14134,3053,0.177634258
M87010,8199,6567,6486,6407,4493,2835,6788,1411,0.172094158
M87011,31614,26545,26210,25858,18257,14332,24006,7608,0.240652875
M87012,7549,5688,5579,5475,3851,2293,6553,996,0.131938005
M87013,11509,9105,8972,8855,6391,3866,9860,1649,0.143279173
M87014,7240,5970,5906,5833,4127,3131,5575,1665,0.229972376
M87015,8743,7332,7226,7137,4798,4059,6416,2327,0.266155782
M87016,6841,5696,5638,5563,3795,3051,5315,1526,0.223066803
M87017,8487,6686,6599,6496,4587,2855,7191,1296,0.152704136
M87018,6042,5150,5104,5050,3192,3062,4160,1882,0.311486263
M87019,6921,5659,5575,5496,3906,2739,5589,1332,0.192457737
M87020,9689,7924,7831,7744,5477,4062,7607,2082,0.214882857
M87021,6811,5493,5418,5346,3666,2689,5431,1380,0.202613419
M87023,9776,8148,8048,7961,5561,4300,7439,2337,0.239054828
M87024,21832,17838,17628,17369,12163,9101,17064,4768,0.218395016
M87025,5043,4137,4089,4029,2750,1941,4061,982,0.194725362
M87026,4858,3916,3846,3789,2683,1806,4006,852,0.175380815
M87027,4422,3581,3538,3482,2459,1649,3626,796,0.180009046
M87028,7558,5921,5801,5711,4052,2640,6303,1255,0.166049219
M87030,3988,3411,3372,3335,2258,1862,2988,1000,0.250752257
M87034,4288,3438,3385,3327,2329,1466,3606,682,0.159048507
M87036,3715,2779,2732,2681,1866,952,3321,394,0.106056528
M87037,6148,5137,5082,5030,3530,2784,4574,1574,0.256018217
M87041,5611,4599,4530,4451,3036,2269,4480,1131,0.201568348
M87601,6519,5026,4942,4866,3348,1905,5694,825,0.126553152
M87602,9975,8166,8047,7917,5524,4118,7878,2097,0.210225564
M87605,4052,3030,2975,2930,2080,1132,3533,519,0.128084896
M87612,2527,2073,2046,2019,1421,972,2081,446,0.176493866
M87617,4665,3439,3378,3325,2352,1055,4289,376,0.080600214
M87618,3210,2694,2652,2599,1975,1317,2710,500,0.15576324
M87620,5717,4517,4452,4379,3189,1781,5097,620,0.108448487
M87621,2966,2443,2406,2367,1729,1103,2530,436,0.146999326
M87623,2825,2146,2104,2059,1382,789,2471,354,0.125309735
M87628,2496,1735,1691,1646,1094,439,2315,181,0.072516026
M87638,3533,2920,2895,2867,1999,1559,2670,863,0.244268327
M88001,7492,5594,5505,5432,3872,2216,6585,907,0.121062467
M88002,8930,7061,6948,6844,4804,2728,7739,1191,0.133370661
M88003,11319,9276,9147,9032,6393,4584,8913,2406,0.212562947
M88004,45738,35675,35130,34603,24617,15369,38470,7268,0.158905068
M88006,12169,8962,8751,8569,5893,2985,10927,1242,0.102062618
M88007,9477,7701,7585,7482,5304,3758,7607,1870,0.197319827
M88008,5720,4683,4605,4534,3181,2164,4724,996,0.174125874
M88009,9281,7079,6966,6855,4733,2874,7985,1296,0.139640125
M88010,9142,6972,6851,6746,4569,2876,7742,1400,0.153139357
M88013,14184,11169,11010,10855,7677,5014,11802,2382,0.167935702
M88014,5004,3956,3900,3850,2807,1556,4317,687,0.137290168
M88015,10362,8400,8287,8162,5800,3784,8619,1743,0.16821077
M88016,1857,1528,1496,1481,1001,724,1451,406,0.218632202
M88018,19707,15473,15247,15029,10757,6318,16914,2793,0.14172629
M88019,2295,1839,1818,1796,1249,723,1946,349,0.152069717
M88020,13294,11094,10976,10834,7890,4943,10941,2353,0.176997142
M88021,5907,4926,4845,4791,3333,2603,4430,1477,0.250042323
M88022,4207,3450,3398,3346,2312,1774,3309,898,0.213453768
M88023,3897,3052,2993,2950,2074,1305,3288,609,0.156274057
M88024,3204,2720,2693,2666,1788,1458,2460,744,0.232209738
M88026,4508,3435,3384,3321,2373,1198,4027,481,0.106699201
M88030,6172,5157,5088,5020,3399,2663,4800,1372,0.222294232
M88031,3994,3185,3131,3089,2100,1459,3319,675,0.169003505
M88035,3322,2586,2535,2495,1809,1078,2841,481,0.144792294
M88038,13889,11100,10919,10760,7635,4733,11737,2152,0.15494276
M88040,8164,6500,6400,6302,4550,2167,7296,868,0.106320431
M88041,3464,2532,2475,2409,1709,669,3235,229,0.066108545
M88042,4717,3724,3665,3611,2683,1272,4230,487,0.103243587
M88043,6466,4903,4825,4756,3508,1919,5676,790,0.122177544
M88044,4028,3334,3285,3228,2436,1282,3509,519,0.128848064
M88600,3254,2510,2474,2419,1639,939,2828,426,0.130915796
M88610,4272,3190,3134,3076,2199,939,3879,393,0.091994382
M88612,4076,3167,3108,3064,2219,1346,3488,588,0.144259078
M88616,11190,8833,8701,8558,6138,3610,9678,1512,0.135120643
M88618,2320,1778,1749,1717,1202,681,2016,304,0.131034483
M88619,8455,6615,6542,6463,4581,2760,7147,1308,0.15470136
M88620,2745,2119,2087,2049,1449,796,2418,327,0.119125683
M88623,2438,1967,1946,1924,1379,858,2028,410,0.168170632
M88625,3156,2449,2404,2369,1689,851,2786,370,0.117237009
M88626,2407,1902,1875,1859,1297,704,2087,320,0.132945575
M88627,2261,1837,1818,1794,1255,853,1868,393,0.173816895
M88628,3051,2445,2397,2360,1808,971,2642,409,0.134054408
M88629,1794,1453,1434,1411,1007,489,1629,165,0.091973244
M88630,5849,4534,4443,4370,3030,1728,5090,759,0.129765772
M88633,5055,3995,3934,3868,2752,1516,4413,642,0.127002967
M88635,1946,1570,1535,1506,996,665,1597,349,0.17934224
M88639,2894,2264,2227,2193,1582,721,2621,273,0.094333103
M88640,3233,2561,2524,2486,1808,995,2790,443,0.137024436
M88643,5253,4090,4030,3971,2804,1571,4611,642,0.122215877
M88645,10923,8558,8418,8283,5874,3629,9427,1496,0.136958711
M88646,1963,1542,1514,1493,1075,660,1681,282,0.143657667
M88647,4196,3079,3021,2967,2163,837,3897,299,0.071258341
M89001,3476,2931,2909,2879,2056,1549,2671,805,0.231588032
M89002,6524,4963,4874,4802,3394,2008,5647,877,0.134426732
M89003,40114,32974,32523,32097,22880,17245,30973,9141,0.227875555
M89005,7878,6597,6515,6425,4458,3437,6049,1829,0.232165524
M89007,5965,4729,4658,4571,3285,2122,5028,937,0.157082984
M89008,9238,7288,7182,7075,4890,3152,7827,1411,0.152738688
M89009,11416,9115,8987,8864,6210,4178,9438,1978,0.173265592
M89010,11158,9289,9153,9017,6267,5290,8285,2873,0.25748342
M89012,11671,9074,8935,8795,5917,3728,9902,1769,0.151572273
M89013,6246,4556,4467,4384,3068,1603,5553,693,0.110951009
M89015,11427,9276,9161,9040,6429,4549,9235,2192,0.191826376
M89016,12970,10812,10662,10520,7500,6089,9766,3204,0.247031611
M89017,55269,44952,44321,43708,31347,22024,43928,11341,0.205196403
M89019,11338,8987,8867,8730,6174,3932,9614,1724,0.152055036
M89021,4003,3395,3364,3331,2297,1817,3086,917,0.229078191
M89024,3041,2450,2422,2387,1729,1147,2509,532,0.174942453
M89026,11234,9024,8900,8788,6253,4439,9094,2140,0.190493146
M89027,7535,5696,5613,5533,3874,2290,6469,1066,0.141473125
M89030,4857,3929,3865,3807,2776,2170,3835,1022,0.210417953
M89602,3624,2962,2935,2896,2070,1477,2915,709,0.195640177
M89608,3196,2552,2511,2467,1843,1308,2591,605,0.189299124
M91003,7375,5956,5862,5784,4110,2881,5987,1388,0.18820339
M91004,9883,7482,7348,7197,5060,2808,8656,1227,0.124152585
M91006,4230,3303,3255,3200,2215,1462,3576,654,0.154609929
M91007,9960,8293,8159,8031,5647,4401,7841,2119,0.212751004
M91008,8662,6620,6483,6352,4327,2561,7462,1200,0.138536135
M91009,5624,4695,4623,4558,3295,2463,4418,1206,0.214438122
M91010,8989,7510,7412,7314,4987,4127,6784,2205,0.245299811
M91011,7171,5882,5798,5714,3851,2976,5522,1649,0.229953981
M91013,10230,8329,8216,8110,5617,3969,8408,1822,0.178103617
M91014,2681,2149,2109,2071,1505,901,2270,411,0.153301007
M91015,9082,7452,7361,7263,5088,3352,7417,1665,0.183329663
M91016,6314,5119,5046,4978,3501,2461,5076,1238,0.19607222
M91017,10066,8503,8417,8335,5608,4942,7255,2811,0.279256904
M91018,3293,2673,2625,2587,1870,1187,2733,560,0.170057698
M91019,15151,12386,12223,12064,8330,6221,12003,3148,0.207775064
M91020,5109,4080,4011,3955,2822,1868,4191,918,0.179682913
M91021,8143,6448,6357,6265,4493,2847,6818,1325,0.162716444
M91024,2419,2074,2046,2018,1373,1191,1738,681,0.28152129
M91026,4147,3018,2964,2902,2075,1093,3680,467,0.112611526
M91028,8759,7011,6925,6829,4886,3312,7069,1690,0.1929444
M91029,4916,3630,3571,3509,2448,1416,4293,623,0.126729048
M91032,5001,4112,4049,3974,2702,2050,4075,926,0.185162967
M91033,5051,4041,3989,3934,2827,1761,4252,799,0.158186498
M91034,4844,4041,3989,3949,2664,2195,3761,1083,0.223575557
M91036,3038,2276,2241,2198,1568,899,2662,376,0.123765635
M91602,1970,1497,1480,1449,1039,612,1713,257,0.130456853
M91609,1904,1501,1482,1455,1052,693,1594,310,0.162815126
M91611,2742,2015,1973,1940,1315,810,2351,391,0.142596645
M91612,3031,2372,2331,2303,1598,1081,2522,509,0.167931376
M91613,9829,7191,7040,6899,4870,1860,9207,622,0.063282124
M91614,6108,4822,4752,4681,3365,2092,5046,1062,0.173870334
M91616,7682,6026,5920,5836,4266,2419,6548,1134,0.147617808
M91619,5018,3790,3727,3658,2603,1315,4448,570,0.113591072
M91621,4802,3466,3375,3311,2296,885,4476,326,0.06788838
M91623,1718,1461,1445,1430,1003,814,1310,408,0.237485448
M91624,3152,2475,2435,2392,1666,1067,2736,416,0.131979695
M91626,4393,3411,3352,3305,2335,1585,3611,782,0.178010471
M91628,2971,2289,2246,2211,1572,866,2596,375,0.126220128
M91629,5855,4252,4171,4116,2866,1292,5369,486,0.083005978
M91637,3611,2940,2904,2879,1942,1629,2662,949,0.262808086
M91639,1842,1522,1498,1476,1109,786,1506,336,0.182410423
M91640,3730,2823,2777,2735,1911,1157,3230,500,0.134048257
M91641,4191,3213,3152,3093,2142,1278,3595,596,0.142209497
M91642,1542,1266,1255,1234,871,607,1271,271,0.175745785
M91647,4757,3844,3789,3741,2654,1948,3783,974,0.204750893
M91650,9183,7486,7401,7304,5016,3821,7262,1921,0.209190896
M91654,2881,2310,2274,2250,1632,1084,2433,448,0.155501562
M91659,2694,1872,1838,1784,1282,518,2504,190,0.070527097
M91660,5005,3722,3656,3591,2605,1343,4406,599,0.11968032
M92001,3351,2622,2576,2528,1854,1049,2959,392,0.116980006
M92002,8215,6973,6885,6792,4520,3892,6130,2085,0.253804017
M92003,1609,1329,1313,1294,924,693,1251,358,0.222498446
M92004,3009,2434,2401,2378,1644,1226,2405,604,0.20073114
M92006,4921,4086,4012,3962,2829,2079,3887,1034,0.210119894
M92007,6932,5458,5371,5289,3819,2225,5902,1030,0.148586267
M92008,12474,10422,10287,10169,7195,5598,9423,3051,0.244588745
M92009,14049,11354,11215,11089,7767,5526,11341,2708,0.192753933
M92010,12103,10134,9985,9855,6731,5433,9123,2980,0.246219945
M92011,11324,9283,9152,9058,6537,4926,8724,2600,0.229600848
M92012,10126,7865,7740,7608,5364,3146,8701,1425,0.140726842
M92013,6877,5394,5309,5230,3685,2187,5895,982,0.142794823
M92014,1954,1687,1668,1648,1200,887,1525,429,0.219549642
M92015,2769,2207,2187,2153,1524,919,2364,405,0.146262189
M92016,18442,14188,13985,13789,9928,4576,16629,1813,0.09830821
M92019,6321,4943,4857,4775,3303,2153,5383,938,0.148394241
M92022,4337,3277,3239,3190,2206,1453,3685,652,0.150334332
M92026,3779,3101,3058,3019,2110,1567,3044,735,0.194495898
M92028,9881,8233,8179,8102,5331,1960,9164,717,0.072563506
M92029,5224,4395,4324,4253,2968,2142,4129,1095,0.209609495
M92039,6767,5424,5351,5281,3776,2505,5636,1131,0.167134624
M92040,8875,6908,6800,6714,4718,2679,7664,1211,0.136450704
M92041,4607,3568,3503,3439,2447,1424,4042,565,0.122639462
M92042,3884,3216,3184,3148,2268,1344,3299,585,0.15061792
M92043,5845,4965,4895,4819,3431,2492,4560,1285,0.219846022
M92044,4325,3594,3540,3485,2371,1941,3292,1033,0.238843931
M92607,14784,11446,11267,11097,7888,3957,13083,1701,0.115056818
M92609,5500,4399,4327,4262,3121,1939,4641,859,0.156181818
M92612,35855,28589,28142,27718,19496,12084,30174,5681,0.158443732
M92627,3384,2692,2650,2611,1835,1302,2721,663,0.195921986
M92629,3626,2759,2688,2627,1871,987,3276,350,0.096525097
M92630,5555,4303,4240,4146,2879,1670,4846,709,0.127632763
M92640,2511,2088,2057,2031,1493,786,2208,303,0.120669056
M92649,3726,2909,2859,2824,1946,1366,3014,712,0.19108964
M92654,7659,5914,5808,5704,3951,2362,6562,1097,0.143230187
N81001,4776,4135,4096,4049,2901,2688,3210,1566,0.327889447
N81002,12974,10816,10661,10519,7609,5964,9832,3142,0.242176661
N81005,9488,7873,7782,7685,5538,4101,7436,2052,0.216273187
N81006,5230,4424,4362,4311,3247,2676,3941,1289,0.246462715
N81007,10409,8817,8719,8617,6317,4573,8117,2292,0.220194063
N81008,10216,8563,8455,8351,5839,4915,7320,2896,0.283476899
N81009,7528,6158,6059,5970,4244,3274,5766,1762,0.234059511
N81010,7053,5801,5723,5648,4118,2969,5585,1468,0.208138381
N81011,14921,12154,11997,11827,8678,5952,12134,2787,0.186783728
N81012,10384,8388,8284,8183,6036,3612,8820,1564,0.150616333
N81013,7701,6344,6281,6198,4595,3125,6166,1535,0.199324763
N81014,9024,7363,7233,7125,5242,4078,7030,1994,0.220966312
N81016,29379,23280,22981,22663,16170,8411,25928,3451,0.117464856
N81018,7899,6637,6540,6451,4578,3999,5705,2194,0.277756678
N81019,12985,10312,10153,10003,7346,4452,10962,2023,0.155795148
N81020,13741,11791,11642,11505,7743,6883,9735,4006,0.291536278
N81022,33482,28284,27952,27652,19954,16709,24392,9090,0.271489158
N81024,10536,8581,8479,8352,5950,4088,8641,1895,0.179859529
N81025,9307,7403,7279,7186,5400,3476,7729,1578,0.169549801
N81026,9759,7929,7809,7720,5677,4425,7460,2299,0.235577416
N81027,13507,11346,11206,11058,7974,6403,10022,3485,0.258014363
N81028,8295,6698,6605,6533,4872,2829,6946,1349,0.162628089
N81029,12709,10733,10604,10490,7470,5496,10020,2689,0.211582343
N81030,17490,14879,14691,14514,10553,8708,12850,4640,0.265294454
N81031,5782,4926,4864,4806,3411,3125,4002,1780,0.307851954
N81032,26026,21491,21214,20969,15184,10914,20718,5308,0.203949896
N81033,8356,7086,6990,6895,4912,4111,6180,2176,0.26041168
N81034,13002,10803,10693,10586,7791,4880,10618,2384,0.183356407
N81035,9994,8390,8293,8196,5875,4455,7721,2273,0.227436462
N81036,7211,6016,5941,5886,4182,2699,5944,1267,0.175703786
N81037,8585,6897,6802,6722,4845,3260,7174,1411,0.164356436
N81038,7294,6116,6019,5929,4291,3501,5459,1835,0.251576638
N81039,11219,9282,9156,9043,6623,4857,8926,2293,0.204385418
N81040,6129,4895,4830,4767,3573,2099,5239,890,0.145211291
N81041,8469,7073,6984,6911,4906,3497,6882,1587,0.187389302
N81042,6950,5807,5729,5658,4025,3421,5019,1931,0.277841727
N81043,5826,5020,4957,4902,3540,2972,4304,1522,0.261242705
N81044,10024,8286,8173,8060,5611,3960,8070,1954,0.194932163
N81045,14446,11902,11752,11620,8374,5926,11617,2829,0.195832756
N81046,10108,8224,8136,8042,5946,3917,8170,1938,0.191729323
N81047,13324,11229,11070,10904,7487,5922,10159,3165,0.237541279
N81048,14093,11430,11274,11113,8010,5075,11701,2392,0.169729653
N81049,6224,5097,5040,4987,3564,2748,4768,1456,0.233933162
N81050,20335,16764,16563,16379,11599,8388,16166,4169,0.205015982
N81051,7307,6142,6066,5992,4372,3523,5463,1844,0.25236075
N81052,11311,9290,9186,9085,6557,4907,8731,2580,0.228096543
N81053,16187,13081,12910,12752,8966,5736,13493,2694,0.166429851
N81054,9049,7319,7203,7088,5232,3280,7521,1528,0.168858437
N81055,7576,6444,6367,6308,4583,3473,5968,1608,0.212249208
N81056,10073,8126,8011,7904,5761,3675,8565,1508,0.149707138
N81057,12909,10681,10562,10439,7459,5380,10164,2745,0.212642343
N81059,12379,10226,10073,9909,7091,5703,9604,2775,0.224169965
N81060,9222,7802,7702,7616,5379,4545,6626,2596,0.281500759
N81061,8219,6725,6635,6578,4854,3415,6559,1660,0.201971043
N81062,15433,12924,12766,12611,9159,6666,12192,3241,0.210004536
N81063,11688,9394,9260,9107,6360,4022,9997,1691,0.144678303
N81064,7299,5917,5853,5768,4227,2708,6016,1283,0.175777504
N81065,7263,5686,5614,5544,3997,2159,6361,902,0.124191106
N81066,14320,11800,11669,11521,8317,5508,11789,2531,0.17674581
N81067,9040,7244,7150,7079,5296,3611,7253,1787,0.197676991
N81068,14207,11654,11507,11342,8018,5261,11836,2371,0.166889561
N81069,4143,3576,3548,3502,2488,2214,2991,1152,0.278059377
N81070,9755,8029,7932,7837,5667,4118,7677,2078,0.213018965
N81071,4746,4097,4046,3999,2982,2514,3455,1291,0.272018542
N81072,8037,6316,6198,6102,4696,2773,6777,1260,0.156774916
N81074,5156,4003,3935,3877,2788,1784,4406,750,0.145461598
N81075,16070,13545,13364,13174,9413,7678,12134,3936,0.244928438
N81077,12527,10526,10363,10227,7327,6284,9022,3505,0.279795641
N81079,9823,8157,8062,7961,5425,3538,8258,1565,0.159319963
N81080,8071,7080,7028,6985,4191,2832,6605,1466,0.181637963
N81081,10927,9718,9648,9597,5278,3240,9278,1649,0.150910588
N81082,15859,13451,13294,13143,9369,7075,12241,3618,0.228135444
N81083,5356,4283,4212,4139,3037,1691,4684,672,0.125466766
N81084,18631,15551,15343,15144,10977,8582,14233,4398,0.236058183
N81085,9178,7596,7515,7430,5407,4058,7099,2079,0.226519939
N81086,12827,10070,9923,9762,7483,4315,10953,1874,0.146098074
N81087,25009,20627,20357,20116,14783,11018,19444,5565,0.222519893
N81088,10953,9159,9031,8921,6557,4741,8593,2360,0.215466082
N81089,8679,7171,7085,6996,5027,3449,6935,1744,0.200944809
N81090,4471,3707,3660,3617,2600,1936,3412,1059,0.236859763
N81092,12328,10172,10042,9916,7136,5126,10020,2308,0.187216093
N81093,16500,13730,13543,13352,9667,6833,13245,3255,0.197272727
N81096,8472,6671,6562,6458,4891,2805,7128,1344,0.158640227
N81097,2703,2258,2233,2206,1552,1110,2131,572,0.211616722
N81100,7225,5678,5606,5532,3999,2916,5728,1497,0.207197232
N81101,7340,6205,6116,6032,4443,3147,5873,1467,0.19986376
N81102,2721,2479,2463,2441,1289,979,2220,501,0.184123484
N81107,3204,2605,2573,2541,1897,1134,2704,500,0.156054931
N81108,10536,8438,8304,8170,6118,4413,8366,2170,0.205960516
N81109,6539,5318,5231,5149,3805,2511,5387,1152,0.176173727
N81111,6312,5210,5165,5112,3672,2807,4897,1415,0.224176172
N81113,6999,5778,5704,5627,4180,2670,5876,1123,0.160451493
N81114,11220,9336,9230,9112,6930,4700,9191,2029,0.18083779
N81115,6986,5437,5354,5300,3884,2299,5864,1122,0.160606928
N81117,5556,4397,4342,4280,3084,1940,4704,852,0.153347732
N81118,7885,6480,6402,6318,4726,3539,6086,1799,0.228154724
N81119,5176,4010,3955,3900,2815,1622,4471,705,0.136205564
N81120,5217,4250,4199,4143,3086,2456,4003,1214,0.232700786
N81121,7073,6085,6026,5962,3780,2566,5743,1330,0.188039022
N81122,10616,8862,8736,8617,6372,4445,8892,1724,0.162396383
N81123,6364,5015,4934,4868,3488,2083,5547,817,0.128378378
N81125,7278,6258,6193,6126,4246,3751,5156,2122,0.291563616
N81127,8147,6674,6605,6515,4509,3367,6553,1594,0.195654842
N81607,2928,2277,2248,2205,1578,863,2591,337,0.115095628
N81614,4584,3853,3797,3747,2813,2253,3540,1044,0.227748691
N81619,3587,2766,2725,2687,1921,957,3244,343,0.095623083
N81623,7756,6413,6303,6189,4622,3388,6343,1413,0.182181537
N81624,8426,6972,6880,6783,4969,4015,6345,2081,0.246973653
N81626,4153,3168,3112,3059,2211,1255,3632,521,0.125451481
N81628,11269,8915,8822,8728,6301,2867,10172,1097,0.097346703
N81632,5549,4463,4403,4344,3325,2024,4771,778,0.140205442
N81637,3104,2570,2546,2522,1855,682,2850,254,0.081829897
N81642,4650,3869,3814,3771,2836,1974,3835,815,0.175268817
N81645,2575,2034,1996,1968,1395,748,2251,324,0.125825243
N81651,3639,2933,2880,2830,2129,1264,3190,449,0.123385545
N81655,389,389,389,387.9543011,318.938172,100.3870968,378,11,0.028277635
N82001,5682,4546,4488,4441,3226,2185,4653,1029,0.181098205
N82002,4309,3289,3253,3203,2285,1420,3656,653,0.151543282
N82003,3861,3090,3042,2996,2125,1424,3176,685,0.177415177
N82004,3201,2550,2518,2488,1800,873,2846,355,0.110902843
N82009,8341,6882,6804,6723,5002,3518,6564,1777,0.213044
N82011,11015,9122,9017,8886,6202,4064,9256,1759,0.15969133
N82014,6650,5553,5475,5408,3906,2751,5337,1313,0.197443609
N82018,13253,10169,10022,9868,7089,4136,11500,1753,0.132271938
N82019,4719,3685,3627,3573,2552,1684,3965,754,0.159779614
N82022,9071,7579,7500,7424,5123,2799,7866,1205,0.132840922
N82024,13100,10761,10608,10467,7600,5210,10702,2398,0.183053435
N82026,6051,5131,5065,5007,3602,2471,4912,1139,0.18823335
N82033,5262,4338,4279,4235,3031,1847,4426,836,0.158874952
N82034,6072,5066,5014,4953,3523,2464,4926,1146,0.188735178
N82035,9296,7614,7529,7437,5402,3835,7462,1834,0.197289157
N82036,3782,3068,3030,2985,2043,1471,3061,721,0.190639873
N82037,11959,10015,9873,9748,6988,4864,9751,2208,0.184630822
N82039,3685,2962,2931,2899,2185,1404,2992,693,0.188059701
N82041,11266,9166,9060,8955,6507,4525,8991,2275,0.201935026
N82046,8493,7382,7325,7263,4605,2583,7335,1158,0.13634758
N82048,6788,5716,5662,5595,3990,2874,5372,1416,0.208603418
N82049,6228,5022,4953,4900,3549,2156,5301,927,0.148843931
N82050,2414,2028,2006,1985,1463,1006,1932,482,0.1996686
N82052,5492,4381,4322,4254,3060,1836,4712,780,0.142024763
N82053,16470,13401,13218,13063,9457,6247,13690,2780,0.168791743
N82054,6873,5638,5580,5529,3965,1882,6133,740,0.107667685
N82058,5037,4115,4042,3984,2816,1837,4263,774,0.153662895
N82059,5428,4678,4626,4581,3390,1829,4732,696,0.128224024
N82062,7203,5956,5897,5831,4457,2825,5859,1344,0.186588921
N82065,4195,3429,3369,3314,2396,1225,3703,492,0.117282479
N82066,8902,7578,7504,7414,5297,4260,6626,2276,0.255672882
N82067,3928,3356,3324,3298,2314,1313,3359,569,0.144857434
N82070,9018,7657,7572,7495,5277,3248,7567,1451,0.160900421
N82073,6619,5578,5523,5482,3934,2656,5321,1298,0.19610213
N82074,9822,8041,7930,7814,5682,3571,8295,1527,0.155467318
N82076,7705,6172,6084,6010,4226,1943,7022,683,0.088643738
N82077,2727,2253,2220,2194,1558,1065,2232,495,0.181518152
N82078,3473,2878,2842,2812,2056,1359,2863,610,0.175640656
N82079,6459,5406,5343,5292,3869,1699,5780,679,0.105124632
N82081,4729,3940,3900,3861,2568,1482,4068,661,0.139775851
N82082,5582,5110,5076,5050,2960,1494,4923,659,0.118058044
N82083,9248,7219,7111,6988,5108,2987,8078,1170,0.126513841
N82084,6945,5956,5883,5827,4147,3302,5344,1601,0.230525558
N82086,3475,2841,2800,2754,1968,1377,2853,622,0.178992806
N82087,2466,2082,2055,2037,1525,1047,2022,444,0.180048662
N82089,3685,2542,2497,2462,1711,695,3435,250,0.067842605
N82090,9616,7846,7751,7641,5368,3503,8102,1514,0.157445923
N82091,2335,1863,1835,1812,1296,655,2082,253,0.108351178
N82092,8243,7050,6978,6890,4475,3517,6471,1772,0.214970278
N82093,3358,2801,2757,2713,1927,1306,2804,554,0.164979154
N82094,7988,6605,6520,6427,4625,3343,6407,1581,0.197921883
N82095,4767,3862,3806,3767,2662,1525,4042,725,0.152087267
N82097,8303,6622,6528,6434,4648,2638,7261,1042,0.125496808
N82099,8025,6289,6202,6135,4387,2303,7065,960,0.119626168
N82101,2688,2266,2240,2208,1583,1177,2093,595,0.221354167
N82103,7567,5926,5853,5758,4059,2169,6763,804,0.106250826
N82104,4331,3710,3676,3634,2628,1940,3428,903,0.208496883
N82106,3682,3137,3108,3080,2189,1753,2766,916,0.248777838
N82107,1597,1422,1408,1405,1054,756,1189,408,0.255479023
N82108,7599,6131,6077,6017,4119,2552,6322,1277,0.168048427
N82109,4526,3644,3602,3566,2571,1588,3867,659,0.145603182
N82110,8022,6361,6271,6183,4525,2805,6938,1084,0.135128397
N82113,6994,5192,5109,5028,3480,1255,6517,477,0.068201315
N82115,7750,6459,6376,6316,4456,2712,6529,1221,0.157548387
N82116,6766,5357,5290,5219,3824,2338,5749,1017,0.150310375
N82117,46756,45351,45304,45221,12009,2809,45919,837,0.017901446
N82617,7386,7077,7064,7053,2159,677,7078,308,0.041700514
N82633,2681,2196,2173,2146,1515,1079,2153,528,0.19694144
N82641,7040,5994,5941,5890,4445,1994,6189,851,0.120880682
N82645,6389,5260,5213,5161,3127,1367,5842,547,0.085615902
N82646,9661,7244,7102,6946,4793,2131,8802,859,0.088914191
N82648,1573,1314,1301,1285,951,579,1353,220,0.13986014
N82650,4017,3079,3026,2979,2128,1073,3637,380,0.094597959
N82651,4485,3740,3704,3659,2668,1713,3643,842,0.187736901
N82655,2445,2009,1992,1961,1338,1053,1860,585,0.239263804
N82662,6784,5016,4910,4826,3489,1695,6110,674,0.099351415
N82663,3837,3050,3010,2964,2112,1353,3206,631,0.164451394
N82664,3184,2522,2482,2445,1874,1053,2727,457,0.143530151
N82668,2645,2110,2073,2032,1447,869,2283,362,0.136862004
N82669,3342,2757,2734,2704,2011,1184,2819,523,0.156493118
N82670,2880,2524,2506,2476,1842,1070,2446,434,0.150694444
N82671,2313,1961,1937,1912,1445,831,1961,352,0.152183312
N82676,4331,3438,3365,3318,2523,1550,3774,557,0.128607712
N82678,2999,2324,2295,2271,1687,921,2608,391,0.130376792
N83001,14404,11552,11346,11170,8140,5281,12113,2291,0.159053041
N83002,12293,9922,9784,9653,6889,4515,10147,2146,0.174570894
N83003,7538,6308,6228,6167,4333,3258,5852,1686,0.223666755
N83005,7961,6631,6563,6471,4511,3499,6259,1702,0.213792237
N83006,3431,2909,2874,2838,2004,1422,2748,683,0.199067327
N83007,2462,2073,2042,2015,1505,1049,1961,501,0.203493095
N83008,7870,6360,6262,6182,4544,2801,6677,1193,0.15158831
N83009,12093,9841,9723,9588,7051,4632,10169,1924,0.159100306
N83010,6911,5918,5838,5774,3831,3327,5178,1733,0.250759659
N83012,10893,9218,9117,9006,6489,4770,8486,2407,0.220967594
N83013,5055,4198,4144,4088,2964,2059,4087,968,0.191493571
N83014,10354,8401,8287,8195,5715,3992,8642,1712,0.165346726
N83015,4348,3483,3454,3410,2318,1499,3724,624,0.143514259
N83017,4585,3962,3921,3881,2719,2000,3462,1123,0.244929117
N83018,8783,7053,6954,6864,4706,3300,7417,1366,0.155527724
N83019,9331,7949,7848,7757,5550,4624,6648,2683,0.28753617
N83020,7462,6189,6095,6038,4350,3263,5726,1736,0.232645403
N83021,8552,6881,6787,6679,4750,3245,6933,1619,0.189312442
N83022,7733,6344,6258,6187,4413,3254,6082,1651,0.213500582
N83023,6611,5426,5357,5291,3740,2686,5322,1289,0.194978067
N83024,7466,6182,6122,6051,4318,3250,5813,1653,0.221403697
N83025,9116,7146,7053,6949,4961,2959,7925,1191,0.130649408
N83026,2617,2202,2175,2159,1577,1229,1965,652,0.249140237
N83027,6581,5506,5436,5378,3760,2843,5036,1545,0.234766753
N83028,25318,20917,20652,20385,14393,9957,20872,4446,0.175606288
N83030,5396,4382,4333,4295,3048,2140,4324,1072,0.198665678
N83031,2577,1990,1972,1939,1435,863,2242,335,0.12999612
N83032,11453,9034,8882,8750,6431,3859,9776,1677,0.146424518
N83033,5976,4971,4915,4858,3670,2489,4899,1077,0.180220884
N83035,7317,6042,5958,5876,4244,2910,6015,1302,0.177941779
N83041,4780,4068,4020,3975,2898,2480,3363,1417,0.296443515
N83043,4066,3319,3275,3240,2286,1592,3404,662,0.162813576
N83045,4767,3738,3695,3654,2660,1507,4127,640,0.134256346
N83047,4555,3786,3744,3695,2676,2041,3550,1005,0.220636663
N83049,3959,3420,3379,3339,2286,2047,2890,1069,0.270017681
N83050,3990,3174,3125,3079,2235,1446,3356,634,0.158897243
N83053,5461,4487,4423,4368,3164,2216,4436,1025,0.187694561
N83054,4122,3334,3284,3230,2389,1564,3423,699,0.169577875
N83055,5713,4513,4462,4390,3160,1892,4983,730,0.12777875
N83060,3616,3006,2976,2941,2119,1630,2776,840,0.232300885
N83601,5746,4474,4406,4356,3129,1703,5086,660,0.114862513
N83603,6194,5106,5035,4963,3531,2466,5040,1154,0.186309332
N83604,2597,2182,2155,2128,1538,1070,2020,577,0.222179438
N83605,5495,4290,4229,4177,3151,1821,4776,719,0.130846224
N83608,10514,8296,8159,8015,5998,3329,9149,1365,0.129826897
N83609,3881,3035,2984,2942,2130,1391,3291,590,0.152022675
N83610,2413,1967,1937,1914,1344,886,2025,388,0.16079569
N83614,4247,3318,3277,3240,2425,1562,3503,744,0.175182482
N83619,2196,1870,1854,1833,1315,1008,1716,480,0.218579235
N83620,3253,2630,2594,2554,1896,1184,2742,511,0.157085767
N83621,2900,2399,2369,2332,1640,1154,2445,455,0.156896552
N83622,2576,2053,2029,1993,1518,809,2345,231,0.089673913
N83624,2927,2482,2463,2433,1766,1237,2367,560,0.191322173
N83628,4147,3243,3203,3164,2315,1261,3623,524,0.126356402
N83633,3770,3058,3021,2983,2041,1441,3103,667,0.176923077
N83635,2650,2296,2267,2226,1528,1188,2085,565,0.213207547
N83637,3434,2841,2804,2774,2034,1420,2762,672,0.195690157
N84001,9712,8218,8104,8012,5890,4405,7600,2112,0.217462932
N84002,2526,2061,2031,2001,1417,902,2107,419,0.165874901
N84003,10836,9228,9124,9022,6161,5342,7841,2995,0.276393503
N84004,7862,6300,6202,6125,4291,2941,6631,1231,0.156575935
N84005,10670,8839,8740,8620,6198,4758,8430,2240,0.209934396
N84006,8056,6968,6879,6777,4490,4356,5348,2708,0.336146971
N84007,5746,4808,4736,4680,3325,2498,4528,1218,0.211973547
N84008,9833,8254,8145,8030,5594,4625,7447,2386,0.242652293
N84010,4695,3860,3818,3785,2729,2045,3672,1023,0.217891374
N84011,6719,5620,5556,5493,4076,2873,5319,1400,0.20836434
N84012,11813,10196,10065,9956,6769,6303,8168,3645,0.308558368
N84013,5922,4981,4916,4856,3496,2731,4531,1391,0.234886863
N84014,3522,2955,2909,2870,2032,1639,2686,836,0.237365133
N84015,6096,5025,4960,4905,3511,2329,5017,1079,0.177001312
N84016,6304,5145,5074,5002,3572,2380,5309,995,0.157836294
N84017,9763,8450,8334,8246,5660,5304,6697,3066,0.314042815
N84018,13003,11025,10875,10771,7335,6696,9020,3983,0.306313928
N84019,6312,5312,5246,5187,3645,2503,5163,1149,0.182034221
N84020,10397,8640,8530,8423,6108,4754,7975,2422,0.232951813
N84021,17401,14799,14640,14488,10336,6989,13929,3472,0.199528763
N84023,7135,5844,5768,5701,4130,2711,5953,1182,0.165662228
N84024,9578,8455,8354,8270,5616,5443,6395,3183,0.332324076
N84025,8171,7088,7010,6943,4697,4305,5666,2505,0.306572023
N84026,3074,2512,2479,2451,1794,1227,2500,574,0.186727391
N84027,4403,3424,3385,3327,2424,1270,3930,473,0.107426754
N84028,7437,6047,5978,5905,4300,2711,6282,1155,0.155304558
N84029,6010,4866,4789,4732,3353,2242,5101,909,0.15124792
N84034,5766,4694,4629,4545,3225,2042,4854,912,0.158168574
N84035,4320,3706,3671,3622,2609,2100,3283,1037,0.240046296
N84037,2105,1753,1730,1712,1218,999,1563,542,0.257482185
N84038,5760,4642,4584,4515,3235,2034,4891,869,0.150868056
N84041,4930,4085,4028,3987,2931,2121,4018,912,0.184989858
N84043,2120,1625,1591,1574,1131,510,1960,160,0.075471698
N84605,3607,2778,2736,2695,1973,1096,3180,427,0.118380926
N84611,4068,3359,3310,3266,2361,1925,3026,1042,0.256145526
N84613,4102,3486,3441,3392,2387,2024,2991,1111,0.270843491
N84614,2870,2427,2401,2377,1720,1430,2057,813,0.283275261
N84615,2682,2231,2213,2187,1574,1008,2238,444,0.165548098
N84617,4069,3242,3188,3148,2350,1431,3414,655,0.160973212
N84618,4561,3836,3787,3731,2648,2186,3445,1116,0.244683184
N84621,2826,2328,2288,2262,1531,1204,2209,617,0.218329795
N84624,875,782,776,764,566,431,675,200,0.228571429
N84625,4322,3400,3337,3280,2418,1556,3705,617,0.142757982
N84626,1957,1704,1684,1658,1208,1036,1427,530,0.270822688
N84627,2504,2129,2111,2085,1539,1168,1922,582,0.232428115
N84630,2737,2123,2085,2063,1480,791,2437,300,0.109609061
N85001,2583,2109,2086,2070,1562,1069,2019,564,0.218350755
N85002,16824,14264,14063,13853,9598,8557,11984,4840,0.287684261
N85003,4545,3674,3629,3567,2628,1841,3628,917,0.201760176
N85005,11625,9616,9485,9361,6557,5118,8956,2669,0.229591398
N85006,9781,7996,7894,7794,5547,4260,7489,2292,0.234331868
N85007,16639,14245,14061,13897,9584,8890,11566,5073,0.304886111
N85008,14152,11929,11763,11636,8124,7118,9988,4164,0.294234031
N85009,5295,4428,4373,4317,3136,2277,4181,1114,0.210387158
N85012,9546,7892,7783,7688,5545,4064,7582,1964,0.205740624
N85013,7989,6782,6694,6606,4634,3906,5807,2182,0.273125548
N85014,5566,4565,4498,4431,3215,2280,4439,1127,0.202479339
N85015,8134,6716,6636,6560,4905,3309,6614,1520,0.186869929
N85016,7875,6407,6319,6240,4492,2921,6537,1338,0.169904762
N85017,5463,4392,4329,4265,3009,1960,4657,806,0.147537983
N85018,6197,5213,5144,5089,3651,2909,4738,1459,0.235436502
N85019,8394,6746,6656,6560,4754,2973,7078,1316,0.156778651
N85020,15190,12251,12072,11890,8428,5635,12668,2522,0.166030283
N85021,2608,2301,2285,2267,1585,1008,2159,449,0.172162577
N85022,2998,2532,2506,2483,1863,1273,2301,697,0.232488326
N85023,5929,4853,4788,4711,3280,2416,4751,1178,0.198684432
N85024,8721,6933,6831,6737,4785,3060,7398,1323,0.151702786
N85025,5792,4814,4748,4697,3397,2571,4559,1233,0.212879834
N85027,10393,8300,8169,8044,5848,3720,8748,1645,0.158279611
N85028,7093,5750,5676,5599,4032,2973,5478,1615,0.227689271
N85031,4138,3409,3370,3326,2376,1531,3462,676,0.163363944
N85032,7177,6103,6021,5964,4220,3719,5012,2165,0.301658074
N85034,5894,4860,4791,4728,3311,2345,4735,1159,0.196640652
N85037,4588,3523,3470,3417,2413,1462,3938,650,0.141673932
N85038,4764,3857,3809,3760,2728,1789,4008,756,0.158690176
N85040,6030,5087,5033,4975,3675,2818,4592,1438,0.238474295
N85044,15180,12270,12109,11937,8442,5877,12322,2858,0.188274045
N85046,4633,3827,3760,3706,2711,1962,3627,1006,0.217137924
N85047,5873,4832,4769,4705,3301,2450,4463,1410,0.24008173
N85048,5380,4507,4460,4409,3203,2421,4188,1192,0.221561338
N85051,7116,5754,5670,5602,4024,2698,5858,1258,0.176784711
N85052,3415,2892,2869,2837,2031,1499,2676,739,0.216398243
N85054,4908,4019,3944,3889,2836,2066,3846,1062,0.216381418
N85057,1978,1732,1712,1697,1271,1009,1437,541,0.273508595
N85059,7221,5988,5915,5835,4343,3410,5548,1673,0.231685362
N85616,4481,3637,3590,3542,2507,1670,3690,791,0.176523098
N85617,4623,3915,3868,3832,2729,2196,3403,1220,0.263897902
N85620,6636,5673,5599,5524,4028,3138,5076,1560,0.235081374
N85625,14616,11751,11578,11422,8255,5322,12306,2310,0.158045977
N85629,4413,3436,3381,3332,2383,1460,3782,631,0.14298663
N85633,3946,3104,3057,3019,2223,1345,3370,576,0.145970603
N85634,1588,1265,1252,1235,882,571,1331,257,0.161838791
N85640,2856,2093,2055,2011,1386,723,2571,285,0.099789916
N85643,4168,3300,3249,3190,2320,1452,3470,698,0.167466411
N85648,3465,2839,2800,2763,2111,1366,2906,559,0.161327561
P81002,66310,57191,56639,56039,29506,18273,57750,8560,0.129090635
P81003,9959,8530,8426,8336,6079,4858,7468,2491,0.250125515
P81004,4681,3653,3590,3542,2602,1621,3995,686,0.146549883
P81005,11788,9411,9269,9131,6294,4498,9582,2206,0.187139464
P81006,18803,16030,15846,15676,10830,9670,13411,5392,0.286762751
P81008,6250,5159,5107,5046,3609,2637,4935,1315,0.2104
P81010,5377,4507,4449,4390,3312,2495,4216,1161,0.215919658
P81013,14971,12513,12370,12222,8783,5945,12159,2812,0.187829804
P81014,8975,7686,7607,7509,5090,4388,6525,2450,0.272980501
P81015,11246,9396,9284,9179,6534,5031,8538,2708,0.240796728
P81016,12112,9779,9639,9516,6858,4491,10208,1904,0.157199472
P81017,13447,11271,11093,10943,8015,6208,10347,3100,0.230534692
P81018,8628,7218,7100,7002,5099,3881,6695,1933,0.224038016
P81020,20572,16488,16265,16061,11429,7474,17229,3343,0.16250243
P81022,10301,8493,8356,8248,5836,4099,8379,1922,0.186583827
P81025,12206,9988,9877,9776,6996,5069,9672,2534,0.207602818
P81027,14795,11719,11560,11385,8469,5616,12220,2575,0.174045286
P81029,18430,15634,15453,15268,10812,9721,12853,5577,0.302604449
P81031,7256,6292,6224,6155,4387,3614,5416,1840,0.253583241
P81032,12102,9523,9378,9264,6563,4424,9836,2266,0.187241778
P81033,8149,6730,6636,6556,4737,3525,6335,1814,0.222604
P81035,6080,4478,4372,4284,3023,1681,5348,732,0.120394737
P81036,15638,12948,12778,12613,8902,6596,12336,3302,0.211152321
P81037,9444,8147,8071,7976,5520,5288,6337,3107,0.328991953
P81038,9153,7472,7368,7274,5298,3575,7420,1733,0.189336829
P81039,5485,4276,4205,4154,2957,1746,4796,689,0.125615314
P81040,10527,8869,8773,8669,6163,5224,7672,2855,0.271207372
P81041,8708,7525,7434,7347,5131,4308,6431,2277,0.261483693
P81042,11642,9578,9468,9350,6705,4340,9767,1875,0.161054802
P81043,5931,5040,4989,4947,3703,2501,4843,1088,0.183442927
P81044,16602,13607,13431,13284,9410,6846,12986,3616,0.217805084
P81045,5178,4456,4402,4348,2918,2394,3824,1354,0.261490923
P81046,6033,5066,5015,4983,3466,1715,5343,690,0.11437096
P81047,15663,12715,12533,12378,8912,6028,12759,2904,0.185405095
P81051,12648,10364,10225,10093,7384,4942,10367,2281,0.180344719
P81053,7684,6335,6265,6197,4534,3235,6114,1570,0.204320666
P81054,9167,7485,7381,7266,5222,3457,7602,1565,0.170721065
P81055,11446,9494,9396,9284,6657,5178,8817,2629,0.229687227
P81057,12609,10455,10302,10156,7221,5418,9869,2740,0.2173051
P81058,9095,7249,7148,7038,5029,3368,7482,1613,0.177350192
P81059,7479,6407,6337,6275,4574,3960,5378,2101,0.280919909
P81061,4642,3891,3847,3783,2675,2051,3661,981,0.211331323
P81062,7912,6573,6482,6396,4561,3391,6258,1654,0.209049545
P81063,11398,9626,9505,9390,6803,4769,9285,2113,0.185383401
P81065,15097,12355,12209,12073,8779,6397,11923,3174,0.210240445
P81066,7406,5890,5809,5729,4053,2749,6148,1258,0.169862274
P81067,13693,10976,10801,10640,7705,5302,11298,2395,0.174906887
P81069,11102,9214,9107,8975,6525,4794,8706,2396,0.21581697
P81070,7551,5989,5916,5837,4067,2995,5924,1627,0.21546815
P81071,7112,5471,5379,5292,3728,2082,6199,913,0.128374578
P81072,15114,12669,12495,12368,8749,6728,11708,3406,0.225353976
P81073,12128,10407,10274,10158,6870,6287,8358,3770,0.310850923
P81074,13457,11381,11226,11095,7910,6108,10435,3022,0.22456714
P81076,11268,9294,9173,9063,6703,4730,8905,2363,0.20970891
P81077,11058,9609,9493,9387,6583,6208,7440,3618,0.327183939
P81078,11915,9800,9674,9561,6985,4997,9364,2551,0.214099874
P81079,12704,10711,10580,10458,7335,6071,9442,3262,0.256769521
P81081,5051,4158,4109,4053,2885,2149,3997,1054,0.20867155
P81082,10188,8577,8482,8393,5984,4724,7759,2429,0.238417746
P81083,8502,7177,7104,7030,4921,3914,6447,2055,0.241707833
P81084,7371,6195,6104,6043,4262,3464,5539,1832,0.248541582
P81086,10226,8221,8057,7910,5398,4158,7981,2245,0.219538431
P81087,11119,9683,9571,9477,6565,6514,7101,4018,0.361363432
P81088,7347,6043,5985,5889,4276,3066,5923,1424,0.193820607
P81089,12104,10026,9882,9750,6940,5154,9498,2606,0.215300727
P81092,8414,7398,7337,7264,4956,4638,5659,2755,0.327430473
P81093,1683,1307,1280,1267,897,436,1494,189,0.112299465
P81095,8577,6696,6576,6454,4508,2987,7039,1538,0.179316777
P81096,7012,5935,5870,5800,4192,3535,5141,1871,0.266828294
P81099,10711,8785,8666,8556,6229,4463,8564,2147,0.200448137
P81100,14437,12052,11804,11555,8203,6662,11033,3404,0.235783057
P81103,10161,8188,8085,7987,5678,4003,8228,1933,0.190237181
P81107,7524,6292,6207,6113,4375,3476,5871,1653,0.21969697
P81112,17218,14481,14300,14136,8393,5934,14383,2835,0.16465327
P81113,6189,5268,5196,5140,3763,3130,4536,1653,0.267086767
P81115,15502,12443,12262,12090,8787,5576,13192,2310,0.149013031
P81117,4453,3587,3542,3497,2556,1748,3534,919,0.206377723
P81118,8490,6654,6556,6446,4755,2749,7237,1253,0.147585395
P81119,8345,6668,6585,6512,4623,2734,7141,1204,0.144278011
P81123,14146,10735,10536,10333,7431,3951,12356,1790,0.126537537
P81125,10212,8278,8162,8032,5671,4037,8163,2049,0.200646298
P81127,4036,3247,3211,3164,2365,1498,3339,697,0.172695738
P81128,9361,7737,7625,7525,5379,4035,7341,2020,0.215788911
P81129,10973,9074,8967,8846,6497,4797,8609,2364,0.215437893
P81130,12819,10410,10267,10132,7357,5400,10074,2745,0.214135268
P81132,9087,7482,7380,7271,5313,3714,7369,1718,0.189061296
P81133,8750,7357,7273,7183,5130,4210,6499,2251,0.257257143
P81134,4341,3562.876781,3521.651709,3479.396011,2534.311254,1929.333333,3258,1083,0.249481686
P81136,2543,2174,2147,2118,1460,1157,1967,576,0.226504129
P81137,6176,5008,4946,4884,3523,2434,5050,1126,0.182318653
P81138,2617,2242,2214,2187,1567,1311,1908,709,0.270920902
P81140,16530,13545,13343,13176,9559,6414,13510,3020,0.182698125
P81143,10152,8307,8181,8064,6191,4303,8229,1923,0.189420804
P81147,4292,3397,3336,3279,2298,1465,3574,718,0.167287978
P81149,7456,6294,6225,6165,4380,3841,5225,2231,0.299222103
P81150,12015,10255,10149,10073,7019,6264,8373,3642,0.303121099
P81154,8347,7043,6955,6877,4984,3971,6273,2074,0.248472505
P81155,5012,4067,4008,3957,2895,1972,4132,880,0.175578611
P81157,10862,9353,9241,9149,6603,5738,7821,3041,0.279966857
P81159,12791,10891,10781,10670,7557,5926,9787,3004,0.234852631
P81160,15257,11975,11793,11597,8298,5142,12933,2324,0.152323524
P81165,2330,1895,1881,1849,1327,941,1854,476,0.204291845
P81166,2601,2074,2051,2027,1446,945,2169,432,0.166089965
P81167,5603,4184,4096,4007,2748,1479,4990,613,0.109405676
P81169,6375,5371,5305,5253,3629,2141,5404,971,0.152313725
P81170,8266,5701,5558,5418,3772,1492,7707,559,0.067626421
P81171,4385,3656,3608,3548,2669,2008,3387,998,0.227594071
P81172,10501,8407,8268,8160,5885,3660,8961,1540,0.1466527
P81173,3640,3115,3074,3037,2233,1762,2806,834,0.229120879
P81179,4416,3651,3615,3562,2653,1780,3611,805,0.182291667
P81180,3411,2733,2692,2649,1969,1190,2840,571,0.16739959
P81181,4474,3622,3580,3532,2612,1751,3574,900,0.201162271
P81182,6044,4378,4277,4171,2885,1415,5417,627,0.103739246
P81184,8298,6242,6121,6016,4330,2422,7310,988,0.119064835
P81185,11263,9240,9097,8959,6720,4605,9194,2069,0.183698837
P81186,4529,3683,3627,3581,2625,1828,3668,861,0.190108192
P81191,9235,7994,7905,7818,5483,4874,6504,2731,0.295722794
P81196,31058,24146,23770,23390,16611,9056,27113,3945,0.127020413
P81197,4649,3688,3639,3604,2649,1722,3879,770,0.165627017
P81201,5296,4258,4183,4124,3058,1842,4520,776,0.14652568
P81204,4718,3742,3672,3603,2587,1507,4111,607,0.12865621
P81208,18044,14346,14137,13939,10084,6459,15211,2833,0.157005099
P81212,4876,3934,3873,3806,2724,1957,3948,928,0.190319934
P81213,18649,16930,16812,16698,6041,3923,16837,1812,0.097163387
P81214,4228,3274,3223,3157,2236,1461,3541,687,0.162488174
P81218,6631,5371,5290,5209,3800,2597,5403,1228,0.185190771
P81620,1196,1015,1002,988,749,626,920,276,0.230769231
P81622,10701,7779,7574,7385,5264,2086,9940,761,0.071114849
P81633,3140,2662,2633,2596,1902,1400,2491,649,0.206687898
P81642,2293,1936.631083,1906.033752,1876.336342,1416.476452,1018.711146,1783,510,0.222416049
P81646,4397,3696,3640,3592,2535,2055,3286,1111,0.252672277
P81647,3925,3023,2962,2910,2096,932,3622,303,0.077197452
P81655,8799,7321,7223,7131,5234,4020,6768,2031,0.230821684
P81664,15678,12342,12139,11972,8807,5238,13494,2184,0.139303483
P81668,6226,4995,4922,4868,3518,2413,5087,1139,0.182942499
P81674,5705,4738,4679,4623,3399,2628,4380,1325,0.23225241
P81681,13307,11089,10954,10837,7636,5825,10325,2982,0.224092583
P81683,7497,5420,5292,5129,3593,1430,6909,588,0.078431373
P81685,2590,2117,2088,2049,1429,853,2236,354,0.136679537
P81686,2617,2059,2038,2013,1442,884,2213,404,0.154375239
P81687,1878,1600,1582,1565,1087,980,1326,552,0.293929712
P81692,2141,1869,1849,1821,1297,1136,1561,580,0.270901448
P81694,4903,3752,3699,3639,2427,936,4579,324,0.066081991
P81695,6001,4891,4819,4756,3391,2727,4629,1372,0.228628562
P81699,2266,1876,1843,1824,1343,931,1881,385,0.169902913
P81701,3192,2648,2615,2578,1890,1325,2643,549,0.171992481
P81704,11185,8750,8587,8422,5933,3470,9660,1525,0.136343317
P81707,5513,4132,4030,3947,2702,1294,5017,496,0.089969164
P81709,4839,3549,3468,3408,2425,1186,4423,416,0.085968175
P81710,9552,8108,7996,7887,5649,4840,7005,2547,0.266645729
P81711,2781,2246,2213,2180,1566,1018,2381,400,0.143833154
P81714,6127,5025,4960,4902,3483,2521,4937,1190,0.194222295
P81721,2535,2062,2022,1988,1439,861,2200,335,0.132149901
P81724,2262,1586,1543,1515,1115,461,2074,188,0.08311229
P81726,1885,1482,1462,1440,980,624,1603,282,0.149602122
P81730,8349,6769,6695,6614,4728,3320,6669,1680,0.201221703
P81731,2771,2049,2002,1970,1373,725,2424,347,0.12522555
P81732,4222,3506,3467,3411,2599,1835,3417,805,0.19066793
P81734,18653,14086,13809,13537,9701,5204,16589,2064,0.110652442
P81735,3396,2505,2467,2424,1735,756,3158,238,0.07008245
P81736,4069,2967,2891,2827,1993,968,3631,438,0.107643156
P81737,1941,1707,1696,1679,1174,1159,1307,634,0.326635755
P81738,1025,877,862,846,612,429,814,211,0.205853659
P81740,4146,3377,3334,3301,2500,1530,3531,615,0.148335745
P81741,2812,2230,2198,2161,1493,875,2458,354,0.125889047
P81742,2314,2033,2013,1998,1407,1263,1612,702,0.303370787
P81748,6079,5053,4994,4950,3468,2497,4914,1165,0.191643362
P81755,8655,7063,6948,6872,4765,3522,6921,1734,0.20034662
P81757,3394,2892,2840,2802,2079,1614,2661,733,0.215969358
P81769,1592,1315,1299,1285,893,650,1318,274,0.172110553
P81770,6055,4811,4736,4672,3319,1402,5597,458,0.075639967
P81771,5014,3940,3886,3808,2705,1600,4271,743,0.148185082
P81780,4954,3643,3581,3517,2414,990,4540,414,0.083568833
P82001,10473,8292,8157,8058,5740,4020,8451,2022,0.193067889
P82002,7653,6095,6002,5882,4198,2725,6310,1343,0.175486737
P82003,15686,12828,12645,12482,9180,5943,12867,2819,0.179714395
P82004,8841,6611,6476,6359,4454,2447,7721,1120,0.126682502
P82005,7216,6030,5953,5884,4248,3077,5705,1511,0.209395787
P82006,7930,6566,6481,6394,4622,3250,6376,1554,0.195964691
P82007,13606,10996,10831,10680,7660,5184,11169,2437,0.179112156
P82008,13766,10587,10388,10213,7308,4430,11732,2034,0.147755339
P82009,6581,5225,5154,5080,3595,2549,5234,1347,0.20468014
P82010,7308,5594,5508,5431,3848,2438,6135,1173,0.160509031
P82011,6389,5290,5227,5176,3668,2668,5109,1280,0.200344342
P82012,6245,5371,5313,5258,3646,2274,5137,1108,0.177421938
P82013,3826,2963,2910,2860,2036,1206,3305,521,0.136173549
P82014,6771,5641,5571,5507,3962,3025,5205,1566,0.231280461
P82015,20491,16929,16710,16496,12164,8752,16172,4319,0.210775462
P82016,12013,10023,9892,9774,6901,5481,8983,3030,0.252226754
P82018,7101,5372,5280,5186,3765,2142,6197,904,0.127306013
P82020,4280,3355,3288,3232,2232,1377,3570,710,0.16588785
P82021,7341,5757,5657,5561,3925,2597,6058,1283,0.174771829
P82022,4465,3415,3346,3270,2334,1341,3805,660,0.147816349
P82023,9456,7977,7896,7802,5623,4442,7251,2205,0.233185279
P82025,4851,3838,3780,3725,2683,1685,4018,833,0.171717172
P82029,3549,2803,2762,2712,1888,1195,3027,522,0.147083686
P82030,3771,2892,2837,2789,1905,822,3441,330,0.087509944
P82031,10728,8603,8451,8333,6037,4202,8765,1963,0.18297912
P82033,2080,1738,1713,1690,1143,677,1768,312,0.15
P82034,3132,2669,2638,2615,1960,1493,2398,734,0.234355045
P82036,2807,2326,2289,2266,1649,1153,2150,657,0.234057713
P82037,4888,3911,3853,3793,2746,1689,4183,705,0.144230769
P82607,5490,4344,4282,4218,2970,1955,4474,1016,0.185063752
P82609,6488,4602,4495,4394,3160,1205,6097,391,0.060265105
P82613,5140,4219,4163,4105,2980,2072,4068,1072,0.208560311
P82616,3722,2501,2428,2370,1712,657,3504,218,0.058570661
P82624,3347,2461,2388,2331,1598,905,2980,367,0.109650433
P82625,2174,1562,1533,1495,1065,445,2015,159,0.073137075
P82626,4577,3464,3409,3348,2318,1273,4048,529,0.115577889
P82627,3855,3108,3066,3021,2280,1463,3302,553,0.143450065
P82629,2073,1613,1586,1551,1097,640,1827,246,0.118668596
P82633,2426,1837,1807,1774,1233,711,2116,310,0.127782358
P82634,4183,3263,3204,3144,2273,1353,3609,574,0.137222089
P82640,4150,2936,2852,2789,1958,761,3901,249,0.06
P82643,6891,5467,5388,5307,3972,2542,5811,1080,0.156726165
P82652,3552,2774,2735,2697,1872,1230,2979,573,0.161317568
P82660,3458,2551,2503,2451,1805,821,3159,299,0.086466165
P83001,12060,9672,9546,9426,6916,3902,10266,1794,0.148756219
P83004,8429,6719,6628,6524,4698,2919,7099,1330,0.157788587
P83005,4817,4078,4040,3994,2776,2113,3695,1122,0.232925057
P83006,8415,6835,6714,6610,5000,3259,6917,1498,0.178015449
P83007,9063,7211,7119,7038,5087,3148,7619,1444,0.15932914
P83009,7870,6583,6512,6426,4666,3578,5968,1902,0.241677255
P83010,3558,2867,2823,2784,2025,1252,3042,516,0.145025295
P83011,7241,5911,5825,5750,4092,3036,5743,1498,0.206877503
P83012,30567,24927,24557,24185,17735,12565,24548,6019,0.196911702
P83015,7292,6177,6116,6046,4235,3306,5468,1824,0.250137137
P83017,4772,3896,3842,3790,2794,1840,3889,883,0.18503772
P83020,19098,15393,15166,14938,10865,7249,15751,3347,0.175253953
P83021,10381,8303,8179,8058,5666,3495,8887,1494,0.143916771
P83024,4291,3471,3420,3350,2351,1518,3547,744,0.173386157
P83025,8568,6019,5912,5807,3969,2442,7404,1164,0.135854342
P83027,2150,1849,1829,1810,1315,951,1689,461,0.214418605
P83603,10160,8405,8277,8157,5834,4328,7854,2306,0.226968504
P83605,7176,5599,5500,5421,3875,2350,6032,1144,0.15942029
P83608,5946,4893,4834,4784,3406,2403,4733,1213,0.204002691
P83609,4117,3296,3239,3192,2384,1492,3504,613,0.148894826
P83611,4025,2877,2813,2751,1923,783,3756,269,0.066832298
P83612,4608,3769,3716,3661,2627,1983,3616,992,0.215277778
P83620,4690,4005,3954,3900,2856,2281,3475,1215,0.259061834
P83621,3115,2450,2415,2379,1701,1058,2647,468,0.15024077
P83623,5143,3989,3910,3840,2827,1884,4303,840,0.163328796
P84004,9130,7070,6947,6836,5095,2585,8094,1036,0.11347207
P84005,10326,9821,9788,9751,1925,808,10009,317,0.030699206
P84009,11251,9167,9044,8919,5321,2329,10419,832,0.073948982
P84010,10734,8820,8708,8600,5785,2549,9822,912,0.084963667
P84012,9920,8310,8213,8107,5953,4048,7950,1970,0.19858871
P84014,5007,3836,3786,3726,2672,1538,4316,691,0.13800679
P84016,8349,6231,6123,6013,4433,1994,7559,790,0.09462211
P84017,13092,10212,10068,9905,6828,3465,11697,1395,0.106553621
P84018,6159,5847,5833,5815,1278,624,5830,329,0.053417763
P84019,11100,8519,8388,8266,6073,3433,9649,1451,0.130720721
P84020,9279,7138,7032,6940,5102,2531,8243,1036,0.111649962
P84021,8888,6716,6602,6493,4676,2457,7842,1046,0.117686769
P84022,6104,4881,4802,4733,3308,2116,5058,1046,0.171363041
P84023,8549,7683,7630,7582,3815,1598,7954,595,0.069598783
P84024,7867,6208,6129,6030,4415,2547,6807,1060,0.134740053
P84025,7243,5608,5505,5411,3957,2243,6265,978,0.135026923
P84026,8001,6031,5896,5790,4178,1632,7546,455,0.056867892
P84027,7372,5674,5559,5444,3929,1953,6604,768,0.104177971
P84028,8683,6530,6399,6307,4549,2565,7550,1133,0.130484855
P84029,9751,7468,7333,7219,5165,2812,8607,1144,0.1173213
P84030,14069,10411,10194,9978,7031,3143,12820,1249,0.088776743
P84032,6327,4886,4795,4709,3369,1907,5575,752,0.118855698
P84033,4158,3274,3227,3181,2272,1345,3563,595,0.143097643
P84034,16245,13448,13313,13198,9729,4669,14157,2088,0.128531856
P84035,16826,15287,15215,15147,6987,3248,15335,1491,0.088612861
P84037,7449,6070,5988,5926,3582,1518,6952,497,0.066720365
P84038,10387,8193,8081,7963,5908,2426,9466,921,0.088668528
P84039,7891,6458,6357,6257,4531,2222,7141,750,0.095044988
P84040,6928,5125,5030,4936,3563,1826,6268,660,0.095265589
P84041,7319,5628,5559,5477,3926,2104,6454,865,0.118185544
P84042,10561,7719,7570,7418,5287,2587,9543,1018,0.096392387
P84043,9463,7087,6968,6862,5125,2309,8577,886,0.093627814
P84045,5345,4290,4235,4162,2974,1822,4593,752,0.140692236
P84046,12050,8863,8730,8577,6251,2339,11290,760,0.063070539
P84047,6332,5064,4989,4924,3549,2397,5219,1113,0.175773847
P84048,6637,5345,5272,5183,3789,2365,5589,1048,0.157902667
P84049,10500,8199,8063,7947,5710,3598,8868,1632,0.155428571
P84050,8161,5956,5829,5710,4016,1784,7577,584,0.071559858
P84051,5212,4002,3940,3882,2811,1593,4560,652,0.125095932
P84052,7217,5489,5384,5307,3772,2005,6460,757,0.104891229
P84053,8121,6367,6275,6180,4618,1901,7407,714,0.087920207
P84054,6725,5403,5328,5240,3742,2232,5816,909,0.135167286
P84056,5048,3959,3883,3817,2581,1236,4589,459,0.0909271
P84059,6293,4799,4710,4619,3316,1769,5589,704,0.111870332
P84061,6086,4900,4830,4788,3542,2132,5161,925,0.15198817
P84064,6733,5947,5919,5888,3506,1196,6329,404,0.06000297
P84065,3895,2945,2897,2842,2103,1105,3518,377,0.096790757
P84066,7243,5846,5748,5664,4097,2196,6361,882,0.121772746
P84067,6862,5546,5470,5383,3795,2656,5658,1204,0.17545905
P84068,16426,13502,13354,13171,10056,4914,14666,1760,0.107147206
P84070,7138,5368,5293,5210,3702,1986,6276,862,0.120762118
P84071,4628,3923,3890,3844,2873,1549,3989,639,0.138072602
P84072,24712,20965,20752,20564,9076,2748,23829,883,0.035731628
P84074,10492,7806,7659,7515,5504,2120,9729,763,0.072722074
P84605,1952,1468,1442,1423,1063,483,1775,177,0.09067623
P84611,6807,5813,5761,5702,3397,1616,6257,550,0.080799177
P84616,7963,6008,5888,5781,3639,1421,7479,484,0.060781113
P84626,5203,4414,4367,4322,2208,814,4908,295,0.056698059
P84630,20095,18325,18240,18104,6510,2166,19439,656,0.032644937
P84635,4194,3076,3022,2978,2015,809,3936,258,0.061516452
P84637,2833,2117,2059,2023,1479,827,2500,333,0.11754324
P84639,2982,2572,2534,2502,1279,599,2738,244,0.081824279
P84640,4635,3602,3543,3478,2407,962,4351,284,0.061272923
P84644,5675,3839,3737,3624,2570,888,5451,224,0.039471366
P84645,6519,5001,4923,4826,3473,1807,5821,698,0.107071637
P84650,6004,4855,4781,4705,3317,1746,5358,646,0.107594937
P84651,4355,3327,3283,3239,2433,1076,3923,432,0.099196326
P84652,7183,5883,5828,5760,4300,1594,6581,602,0.083808993
P84663,4687,3671,3610,3552,2538,1292,4239,448,0.095583529
P84665,2794,2325,2292,2265,1586,811,2501,293,0.104867573
P84669,13970,12126,12050,11936,6269,1693,13489,481,0.034430923
P84672,3241,2565,2521,2484,1894,1033,2744,497,0.153347732
P84673,11326,10205,10124,10028,6311,1858,10671,655,0.057831538
P84678,14213,11936,11815,11721,8330,3269,12924,1289,0.09069162
P84679,1792,1345,1315,1287,929,485,1621,171,0.095424107
P84683,8111,7937,7931,7927,4606,1233,7840,271,0.033411417
P84684,5111,3888,3805,3720,2606,1207,4651,460,0.090001957
P84689,4845,3559,3467,3398,2451,831,4587,258,0.053250774
P84690,2817,2137,2099,2056,1473,757,2521,296,0.105076322
P85001,5057,4036,3959,3880,2655,1739,4235,822,0.162546965
P85002,5098,4109,4050,3997,2860,1931,4257,841,0.164966654
P85003,6766,4586,4457,4335,2878,1011,6433,333,0.049216672
P85004,5321,4068,3974,3881,2719,1606,4600,721,0.135500846
P85005,9319,7852,7763,7649,5517,4289,7127,2192,0.235218371
P85006,5903,4927,4866,4811,3538,2552,4686,1217,0.206166356
P85007,2706,2079,2045,2022,1392,890,2262,444,0.164079823
P85008,12784,10661,10525,10401,7156,5429,10141,2643,0.206742804
P85010,9587,7807,7702,7588,5478,3954,7549,2038,0.212579535
P85011,8374,6604,6489,6385,4502,2904,6997,1377,0.164437545
P85012,5260,3854,3764,3685,2664,1359,4721,539,0.102471483
P85013,16571,13811,13622,13456,9636,7348,12779,3792,0.228833504
P85014,5570,4288,4216,4139,2929,1562,4973,597,0.107181329
P85015,7564,5672,5559,5452,3675,2134,6560,1004,0.132734003
P85016,14059,11889,11723,11569,8627,6838,10610,3449,0.24532328
P85017,9266,7836,7738,7643,5386,4414,6808,2458,0.265270883
P85018,4554,3696,3633,3597,2600,1583,3843,711,0.156126482
P85019,4588,3749,3699,3645,2637,1771,3814,774,0.168700959
P85020,7902,6315,6229,6135,4416,2996,6543,1359,0.171981777
P85021,10601,7886,7711,7540,5247,2733,9438,1163,0.109706631
P85022,4522,3535,3476,3438,2493,1535,3877,645,0.142636002
P85026,6179,5022,4950,4892,3502,2313,5128,1051,0.170092248
P85028,5394,3954,3864,3795,2654,1500,4665,729,0.135150167
P85601,2270,1732,1705,1673,1144,631,2006,264,0.116299559
P85602,2619,1964,1932,1905,1405,759,2330,289,0.110347461
P85605,4401,3239,3179,3107,2204,1052,3979,422,0.095887298
P85606,3478,2616,2575,2544,1863,1026,3058,420,0.120759057
P85607,3398,2707,2663,2622,1955,1176,2938,460,0.135373749
P85608,2938,2301,2249,2215,1621,923,2548,390,0.132743363
P85610,4087,3208,3165,3124,2256,1202,3656,431,0.105456325
P85612,2929,2131,2066,2006,1377,510,2732,197,0.06725845
P85614,3206,2475,2452,2419,1809,1046,2737,469,0.14628821
P85615,11153,7883,7675,7481,5068,2119,10292,861,0.07719896
P85620,3131,2281,2225,2173,1534,777,2829,302,0.096454807
P85621,5405,3639,3546,3462,2405,1150,4897,508,0.093987049
P85622,5257,3408,3324,3236,2208,730,5031,226,0.042990299
P86001,6700,5508,5439,5364,3943,2536,5432,1268,0.189253731
P86002,1670,1340,1317,1297,944,615,1393,277,0.165868263
P86003,11977,9921,9761,9647,6823,5378,9296,2681,0.223845704
P86004,9623,7852,7751,7658,5552,3803,7883,1740,0.180816793
P86005,6297,5055,4966,4899,3651,2269,5328,969,0.153882801
P86006,13841,10814,10655,10484,7371,4550,11660,2181,0.15757532
P86007,12562,10090,9940,9807,6920,4581,10462,2100,0.167170833
P86008,9296,7159,7059,6940,4871,3151,7762,1534,0.165017212
P86009,9964,8094,7981,7870,5516,3979,7882,2082,0.208952228
P86010,8373,6689,6596,6506,4795,3187,6883,1490,0.177952944
P86011,9119,7437,7345,7263,5312,3718,7291,1828,0.200460577
P86012,8580,6659,6554,6458,4782,2831,7379,1201,0.13997669
P86013,7260,5753,5662,5564,4066,2532,6125,1135,0.156336088
P86014,8645,6306,6152,6020,4185,1719,7991,654,0.075650665
P86015,4308,3546,3496,3447,2500,1609,3544,764,0.177344475
P86016,9640,7707,7595,7495,5456,3363,8183,1457,0.151141079
P86017,4252,3053,2972,2884,1966,760,3956,296,0.069614299
P86018,8872,7224,7124,7035,5120,3661,6986,1886,0.2125789
P86019,9094,7499,7396,7308,5334,3725,7298,1796,0.197492852
P86021,3360,2748,2719,2690,1980,1424,2616,744,0.221428571
P86022,9155,7516,7406,7299,5290,3782,7465,1690,0.18459858
P86023,7534,5994,5913,5831,4218,2553,6326,1208,0.160339793
P86026,7690,6031,5943,5849,4192,2709,6336,1354,0.176072822
P86602,3477,2775,2736,2702,1984,1296,2935,542,0.155881507
P86606,4877,3707,3633,3576,2637,1398,4359,518,0.106212836
P86608,4123,3388,3352,3319,2487,1671,3449,674,0.163473199
P86609,2335,1717,1672,1635,1109,476,2159,176,0.075374732
P86614,5163,3703,3630,3535,2466,934,4873,290,0.056168894
P86619,6382,4498,4388,4278,3020,1208,6022,360,0.056408649
P86620,2356,1809,1773,1754,1275,681,2100,256,0.108658744
P86624,4064,3285,3234,3178,2346,1641,3250,814,0.200295276
P87002,11608,9470,9344,9233,6698,4485,9515,2093,0.180306685
P87003,4132,3455,3413,3364,2387,1477,3480,652,0.157792836
P87004,3681,3071,3029,2993,2132,1203,3120,561,0.152404238
P87008,8280,6839,6751,6671,4728,3248,6628,1652,0.199516908
P87014,3924,3380,3340,3309,2208,1825,2951,973,0.247961264
P87015,3589,3010,2970,2936,2039,1279,2968,621,0.173028699
P87016,13010,10745,10614,10491,7644,5569,10126,2884,0.221675634
P87017,5287,4364,4290,4230,3036,2179,4231,1056,0.1997352
P87019,12297,10001,9893,9775,6940,4576,9993,2304,0.187362771
P87020,6685,5452,5382,5323,3751,2464,5568,1117,0.167090501
P87022,2052,1745,1729,1713,1276,872,1657,395,0.192495127
P87024,10268,8200,8096,8008,5625,3212,8907,1361,0.132547721
P87025,9509,7524,7429,7342,5343,2956,8246,1263,0.132821537
P87026,11476,8891,8737,8602,6107,3120,10141,1335,0.116329732
P87027,18134,16277,16186,16094,7714,2966,16933,1201,0.066229183
P87028,6877,5415,5362,5305,3805,2277,5767,1110,0.161407591
P87032,5403,4465,4424,4376,3123,2067,4466,937,0.173422173
P87035,10546,9054,8998,8932,5517,1928,9769,777,0.073677224
P87039,4161,3293,3247,3201,2262,1509,3471,690,0.165825523
P87040,9077,7466,7350,7235,5229,3336,7669,1408,0.15511733
P87610,9094,7159,7067,6956,5003,3127,7738,1356,0.149109303
P87613,3421,2533,2472,2433,1807,1020,2977,444,0.129786612
P87618,2067,1667,1649,1634,1136,734,1708,359,0.173681664
P87620,9391,7547,7470,7391,5540,3000,8070,1321,0.140666596
P87624,5207,4155,4104,4055,3101,1921,4346,861,0.165354331
P87625,2357,1804,1768,1736,1235,710,2105,252,0.106915571
P87627,3041,2460,2419,2381,1801,1074,2596,445,0.146333443
P87630,2870,2179,2144,2108,1473,858,2564,306,0.106620209
P87634,9776,8036,7945,7870,5508,2462,8787,989,0.101166121
P87639,3123,2566,2541,2520,1612,592,2908,215,0.06884406
P87648,5491,2955,2799,2670,1413,509,5268,223,0.04061191
P87649,2757,2117,2088,2071,1518,722,2508,249,0.09031556
P87651,5482,2828,2714,2624,1546,572,5211,271,0.049434513
P87654,10589,8499,8380,8253,5960,2966,9447,1142,0.107847767
P87657,2833,2291,2260,2224,1591,1086,2313,520,0.183551006
P87658,3261,2609,2577,2548,1725,807,2906,355,0.108862312
P87659,3995,3297,3266,3229,2392,1357,3408,587,0.146933667
P87660,2563,1974,1951,1923,1416,526,2405,158,0.061646508
P87661,2152,1556,1521,1500,1045,546,1954,198,0.092007435
P88002,6391,5376,5306,5240,3796,3185,4675,1716,0.268502582
P88003,9058,7524,7446,7367,5229,3636,7312,1746,0.192757783
P88005,11766,9512,9390,9249,6592,4246,9885,1881,0.159867415
P88006,7498,6155,6084,6026,4354,3344,5636,1862,0.248332889
P88007,13323,10951,10805,10652,7699,5663,10409,2914,0.218719508
P88008,8199,6714,6615,6534,4858,3143,6689,1510,0.184168801
P88009,3199,2648,2615,2588,1818,1329,2508,691,0.216005002
P88011,7374,6019,5961,5889,4291,2797,6061,1313,0.178058042
P88012,8031,6783,6675,6600,4545,3657,6074,1957,0.243680737
P88013,12975,10637,10520,10388,7734,5262,10600,2375,0.183044316
P88014,4762,3896,3837,3782,2745,1816,3913,849,0.178286434
P88015,12550,10487,10343,10202,7074,5989,9105,3445,0.274501992
P88016,14530,11695,11528,11375,8289,5411,11984,2546,0.175223675
P88017,6900,5829,5757,5685,3988,3317,5020,1880,0.272463768
P88018,9183,7308,7193,7095,5166,3092,7829,1354,0.147446368
P88019,5537,4389,4329,4262,3120,1914,4517,1020,0.184215279
P88020,11898,9721,9613,9489,6924,4664,9526,2372,0.199361237
P88021,7133,5979,5923,5864,4171,3423,5220,1913,0.268190102
P88023,6461,5190,5117,5046,3621,2484,5105,1356,0.209874632
P88024,9522,7648,7545,7435,5417,3695,7667,1855,0.194812014
P88025,10941,8978,8850,8722,6460,4664,8562,2379,0.217438991
P88026,44459,35556,35101,34670,25796,15035,37920,6539,0.147079332
P88031,5524,4473,4412,4348,3199,1979,4683,841,0.15224475
P88034,3895,3202,3154,3114,2280,1423,3303,592,0.15198973
P88041,6488,5212,5128,5050,3647,2667,5139,1349,0.207922318
P88042,6712,5401,5329,5263,3640,2626,5277,1435,0.213796186
P88043,9156,6953,6838,6731,4673,2616,8072,1084,0.118392311
P88044,4441,3690,3646,3606,2539,1791,3549,892,0.200855663
P88600,1761,1505,1487,1472,1115,782,1412,349,0.198182851
P88606,5735,4634,4585,4530,3202,2086,4595,1140,0.198779425
P88607,2916,2421,2381,2342,1698,1251,2299,617,0.211591221
P88610,3589,2966,2932,2894,2064,1316,3006,583,0.162440791
P88615,1517,1240,1221,1202,891,533,1283,234,0.154251813
P88623,6184,5254,5201,5134,3634,3060,4526,1658,0.268111255
P88625,8269,6869,6776,6682,4743,3568,6564,1705,0.206191801
P88632,16828,13329,13149,13001,9625,4908,14856,1972,0.117185643
P89002,10282,8377,8258,8149,5910,3980,8459,1823,0.177300136
P89003,9495,7788,7707,7614,5484,3983,7559,1936,0.203896788
P89004,6989,5928,5857,5801,4269,3348,5389,1600,0.228931178
P89005,8100,6376,6277,6201,4559,2755,6878,1222,0.150864198
P89006,12094,9951,9810,9693,7326,4932,9706,2388,0.197453283
P89007,6709,5566,5513,5441,3910,2721,5344,1365,0.203458041
P89008,18581,15092,14886,14672,10436,7132,15209,3372,0.181475701
P89010,8256,6962,6881,6805,4762,3661,6557,1699,0.205789729
P89011,4894,3733,3682,3626,2585,1436,4313,581,0.118716796
P89012,7944,6430,6343,6265,4517,3076,6458,1486,0.187059416
P89013,5614,4258,4190,4117,2958,1750,4903,711,0.126647667
P89014,12977,10243,10096,9944,7150,4469,10934,2043,0.15743238
P89015,20184,16736,16520,16317,11591,8461,16143,4041,0.200208086
P89016,9141,7430,7334,7227,5130,3597,7325,1816,0.198665354
P89018,8035,6496,6420,6346,4495,2981,6609,1426,0.177473553
P89020,8127,6416,6320,6228,4548,2779,6879,1248,0.1535622
P89021,10899,8642,8492,8354,6123,4001,8927,1972,0.180934031
P89022,3826,3127,3079,3035,2188,1335,3218,608,0.158912703
P89023,5312,4430,4376,4328,3159,2206,4272,1040,0.195783133
P89025,3066,2558,2526,2489,1786,1228,2543,523,0.170580561
P89026,6291,5217,5153,5102,3663,2418,5182,1109,0.17628358
P89029,5943,4950,4890,4836,3408,2394,4786,1157,0.19468282
P89030,4400,3640,3582,3535,2669,1699,3630,770,0.175
P89602,4288,3551,3501,3453,2554,1832,3455,833,0.19426306
P89609,4713,3616,3547,3488,2561,1426,4172,541,0.114788882
P89612,2171,1757,1730,1708,1320,783,1841,330,0.152003685
P89613,3006,2276,2217,2193,1607,970,2576,430,0.143047239
P89618,2134,1736,1706,1684,1254,778,1826,308,0.144329897
P91003,6356,5093,5011,4929,3622,2392,5169,1187,0.186752675
P91004,7830,6153,6063,5992,4512,2333,6746,1084,0.13844189
P91006,13114,10727,10579,10436,7558,5226,10534,2580,0.196736312
P91007,4404,3595,3545,3505,2568,1724,3519,885,0.200953678
P91008,6138,5096,5012,4913,3413,2870,4661,1477,0.240632128
P91009,11621,9650,9501,9390,6766,5077,9056,2565,0.220721108
P91011,5791,4683,4589,4514,3231,2518,4528,1263,0.218097047
P91012,6208,5238,5153,5094,3636,2836,4805,1403,0.225998711
P91013,10579,8396,8281,8168,6010,3665,8764,1815,0.171566311
P91014,15748,12570,12418,12247,9326,5511,13080,2668,0.169418339
P91016,8920,6850,6745,6657,5065,2836,7556,1364,0.152914798
P91017,8363,6550,6462,6376,4707,3114,6832,1531,0.183068277
P91018,13643,10781,10625,10506,7862,4507,11729,1914,0.140291725
P91019,3646,2761,2708,2663,1939,1171,3176,470,0.128908393
P91020,7663,5994,5903,5789,4081,2151,6844,819,0.106877202
P91021,15328,12568,12368,12162,8807,6209,12433,2895,0.188870042
P91026,5339,4105,4038,3977,2769,1836,4526,813,0.152275707
P91029,10344,8420,8298,8175,6092,3756,8647,1697,0.164056458
P91032,4868,3815,3771,3725,2833,1714,4036,832,0.170912079
P91035,8965,7175,7085,7000,5186,3183,7399,1566,0.174679308
P91603,7222,5624,5541,5448,4171,2410,6078,1144,0.158404874
P91604,17063,13527,13296,13058,9637,6810,13747,3316,0.194338627
P91617,2438,1970,1953,1930,1448,775,2117,321,0.131665299
P91619,4247,3331,3285,3230,2297,984,3881,366,0.086178479
P91623,5291,4333,4278,4217,3088,2289,4149,1142,0.215838216
P91625,4799,4013,3964,3924,2897,2006,3858,941,0.196082517
P91627,6862,5373,5302,5216,3834,2238,5878,984,0.143398426
P91629,11821,9413,9251,9083,6416,3319,10604,1217,0.102952373
P91631,3411,2651,2617,2587,1954,1175,2842,569,0.166813251
P91633,5331,4209,4133,4063,2999,1990,4424,907,0.170136935
P92001,5417,4604,4544,4491,3192,2435,4165,1252,0.231124239
P92002,5348,4517,4460,4403,3263,2341,4109,1239,0.231675393
P92003,8876,7359,7291,7209,5252,3485,7278,1598,0.180036052
P92004,7986,6599,6527,6443,4471,3395,6238,1748,0.218883045
P92005,4170,3394,3338,3299,2425,1689,3261,909,0.217985612
P92006,5978,4955,4898,4829,3392,2480,4719,1259,0.210605554
P92007,6856,5579,5493,5422,3911,2596,5714,1142,0.166569428
P92008,8792,7291,7192,7092,4982,3734,6841,1951,0.221906278
P92010,12643,10425,10290,10164,7333,5295,10052,2591,0.204935537
P92011,7617,6379,6284,6198,4496,3145,6164,1453,0.190757516
P92012,4461,3707,3653,3602,2511,1886,3472,989,0.221699171
P92014,12582,10493,10373,10259,7338,5451,9837,2745,0.218168813
P92015,5491,4689,4626,4571,3277,2643,4114,1377,0.250773994
P92016,17595,14581,14377,14173,10166,7014,14185,3410,0.193805058
P92017,12687,10714,10567,10436,7558,5911,9607,3080,0.242768188
P92019,10135,7878,7776,7678,5434,3291,8489,1646,0.162407499
P92020,4652,3785,3741,3707,2823,1914,3700,952,0.204643164
P92021,6241,5132,5059,4998,3532,2649,4796,1445,0.231533408
P92023,8828,7448,7371,7287,5187,3944,6871,1957,0.221681015
P92024,4576,3725,3679,3627,2746,1691,3849,727,0.158872378
P92026,7833,6452,6373,6291,4476,3141,6438,1395,0.178092685
P92028,4932,4034,3992,3940,2823,1931,3967,965,0.195660989
P92029,4359,3456,3404,3351,2467,1472,3699,660,0.151410874
P92030,4562,3795,3755,3715,2744,1702,3787,775,0.169881631
P92031,3510,2838,2798,2773,2012,1283,2842,668,0.19031339
P92033,4747,3912,3859,3822,2860,1893,3913,834,0.175689909
P92034,5688,4773,4706,4651,3292,2601,4414,1274,0.223980309
P92035,4328,3456,3398,3360,2435,1436,3687,641,0.14810536
P92038,3172,2514,2477,2441,1879,1091,2638,534,0.168348045
P92041,8139,6687,6580,6496,4597,3235,6525,1614,0.19830446
P92042,6198,5224,5159,5098,3528,2764,4830,1368,0.22071636
P92602,2289,1858,1839,1819,1297,890,1837,452,0.197466142
P92605,5904,4746,4677,4604,3398,2264,4833,1071,0.181402439
P92607,7939,6616,6532,6445,4601,3466,6229,1710,0.215392367
P92615,2660,2129,2097,2071,1560,1015,2155,505,0.189849624
P92616,3411,2645,2600,2561,1793,1082,2897,514,0.150688948
P92620,4156,3173,3124,3083,2291,1113,3755,401,0.096487007
P92621,3222,2700,2663,2627,1924,1301,2616,606,0.188081937
P92623,2259,1897,1870,1843,1306,910,1833,426,0.188579017
P92626,5248,4300,4252,4204,2958,2106,4161,1087,0.207126524
P92630,2519,2122,2094,2070,1531,1015,2047,472,0.187375943
P92633,2241,1887,1870,1852,1279,916,1791,450,0.200803213
P92634,4324,3741,3714,3681,2674,1831,3540,784,0.181313599
P92635,2232,1882,1862,1835,1334,981,1775,457,0.204749104
P92637,3122,2469,2421,2382,1792,1015,2768,354,0.113388853
P92639,2984,2408,2366,2335,1682,1172,2413,571,0.191353887
P92642,5389,4416,4357,4307,3092,2105,4439,950,0.176285025
P92646,3271,2647,2612,2578,1997,1318,2618,653,0.19963314
P92647,3090,2634,2611,2580,1840,1505,2315,775,0.250809061
P92648,3324,2741,2699,2669,1949,1355,2679,645,0.194043321
P92651,4843,3991,3947,3887,2816,1974,3985,858,0.177162916
P92652,3821,3090,3045,3000,2195,1474,3103,718,0.187908924
P92653,3215,2528,2488,2449,1818,1062,2749,466,0.144945568
Y00020,10013,9146,9100,9059,5489,1974,9308,705,0.070408469
Y00026,2167,1753,1728,1706,1242,728,1873,294,0.135671435
Y00033,6174,4401,4308,4237,3308,1126,5863,311,0.05037253
Y00050,2227,1811,1774,1742,1224,707,1943,284,0.127525819
Y00056,636,636,636,636,559,207,610,26,0.040880503
Y00057,11935,8949,8772,8604,6104,2826,11011,924,0.077419355
Y00058,15005,11586,11454,11292,8688,2652,14385,620,0.04131956
Y00060,663,663,663,663,542,175,642,21,0.031674208
Y00078,4340,3298,3237,3185,2290,1308,3712,628,0.144700461
Y00080,7301,6064,5998,5931,4455,3316,5566,1735,0.23763868
Y00090,8510,6665,6539,6405,4613,2242,7654,856,0.100587544
Y00110,2030,1545,1509,1476,1040,539,1830,200,0.098522167
Y00137,6042,4424,4349,4269,3018,1346,5575,467,0.077292287
Y00140,2255,1912,1889,1872,1306,1037,1739,516,0.228824834
Y00155,9143,6756,6617,6476,4647,1825,8549,594,0.064967735
Y00159,26103,20395,20010,19670,13609,8299,22368,3735,0.143087001
Y00184,9425,7091,6947,6840,4556,1088,9115,310,0.032891247
Y00185,11021,8606,8494,8373,6476,3340,9636,1385,0.125669177
Y00186,1608,1142,1103,1073,701,260,1546,62,0.038557214
Y00200,3701,3230,3218,3201,2393,830,3456,245,0.066198325
Y00206,9033,7341,7255,7169,4968,1546,8615,418,0.04627477
Y00212,4721,4017,3974,3934,2746,599,4523,198,0.041940267
Y00228,2231,1647,1586,1524,914,319,2127,104,0.046615867
Y00252,3159,2574,2534,2493,1905,1330,2526,633,0.200379867
Y00260,4556,3448,3395,3346,2537,1270,4035,521,0.114354697
Y00265,9627,7184,7102,7019,5311,1135,9388,239,0.02482601
Y00278,3049,2295,2244,2217,1555,891,2629,420,0.137750082
Y00286,3882,3151,3108,3070,2192,1557,3145,737,0.189850592
Y00293,9291,7659,7559,7463,5476,4237,7182,2109,0.226993865
Y00297,4754,3687,3640,3598,2601,1692,3920,834,0.175431216
Y00312,4918,3564,3483,3414,2470,1239,4453,465,0.09455063
Y00316,4419,3497,3446,3404,2554,1390,3833,586,0.132609188
Y00328,3408,2790,2750,2718,1977,933,3050,358,0.105046948
Y00344,1298,1057,1051,1044,643,95,1283,15,0.01155624
Y00347,5303,4307,4231,4174,2974,2091,4279,1024,0.193098246
Y00351,11243,8973,8845,8731,6397,3785,9582,1661,0.147736369
Y00352,15933,11767,11574,11384,8225,2643,15189,744,0.046695538
Y00399,4091,3399,3351,3309,2438,1775,3171,920,0.224883891
Y00403,6916,5882,5823,5773,4126,846,6718,198,0.028629265
Y00411,10487,8289,8184,8086,5812,3588,8996,1491,0.142176027
Y00412,5275,4180,4113,4038,2912,1306,4783,492,0.093270142
Y00437,9451,7037,6917,6783,5190,2285,8660,791,0.083694847
Y00445,17937,13471,13258,13053,9179,3938,16507,1430,0.079723477
Y00446,3171,2719,2686,2638,1856,1489,2455,716,0.225796279
Y00449,27490,20796,20525,20256,13783,5498,25683,1807,0.065732994
Y00454,1145,1003.970715,997.0671835,983.2601206,642.0284238,224.3647717,1107,38,0.033187773
Y00469,11253,9071,8962,8828,6208,4316,9042,2211,0.196480938
Y00471,5457,4424,4362,4309,2945,1334,4953,504,0.092358439
Y00475,4841,3957,3903,3855,2789,1982,3801,1040,0.214831646
Y00486,7207,5405,5332,5241,4114,1714,6589,618,0.085749965
Y00492,7968,5706,5590,5497,3973,1064,7729,239,0.02999498
Y00507,2459,2035,2001,1981,1428,773,2138,321,0.13054087
Y00522,8685,6431,6347,6261,4823,2183,7801,884,0.101784686
Y00542,9722,7800,7686,7552,5635,3440,8365,1357,0.139580333
Y00560,7723,5707,5620,5529,4156,2129,6795,928,0.120160559
Y00561,3340,2423,2377,2351,1806,712,3098,242,0.07245509
Y00568,3569,2837,2789,2744,1966,968,3158,411,0.115158308
Y00589,6160,5087,5040,5001,3738,2584,4923,1237,0.200811688
Y00612,6310,4789,4695,4595,3303,1510,5830,480,0.076069731
Y00726,5074,3964,3922,3867,2877,1659,4380,694,0.136775719
Y00758,2416,1848,1823,1790,1259,703,2113,303,0.125413907
Y00774,5406,4549,4487,4438,3192,2389,4088,1318,0.243803182
Y00902,4177,3338,3285,3228,2300,964,3874,303,0.072540101
Y00912,1986,1660,1647,1629,1253,714,1694,292,0.147029204
Y00918,6723,5320,5251,5177,3849,1794,5963,760,0.113044772
Y00969,11785,9899,9778,9681,7021,5925,8678,3107,0.263640221
Y00996,3193,2346,2305,2267,1422,226,3171,22,0.006890072
Y00999,11602,8569,8435,8317,6264,2647,10690,912,0.078607137
Y01008,53800,44109,43555,43042,30325,23023,41938,11862,0.220483271
Y01011,11279,9353,9265,9160,6600,2360,10488,791,0.070130331
Y01050,6972,5896,5805,5717,4113,3315,5286,1686,0.241824441
Y01051,10666,9120,9026,8934,6454,5279,7776,2890,0.270954435
Y01066,8789,7257,7198,7141,4642,1446,8326,463,0.052679486
Y01068,4439,3061,2943,2841,1846,580,4248,191,0.043027709
Y01090,4885,3993,3943,3887,2717,1073,4466,419,0.085772774
Y01108,3350,2724,2687,2647,1962,1145,2897,453,0.135223881
Y01118,3339,2663,2619,2586,1877,1113,2859,480,0.143755615
Y01124,4211,3166,3110,3053,2198,1069,3821,390,0.092614581
Y01127,5536,4525,4470,4426,3234,2589,4104,1432,0.25867052
Y01132,14279,12227,12119,12008,8900,3668,12888,1391,0.097415785
Y01139,3936,3201,3144,3091,2301,1409,3328,608,0.154471545
Y01163,4148,3482,3445,3405,2468,2027,3084,1064,0.256509161
Y01165,4364,3053,2991,2945,2235,834,4055,309,0.070806599
Y01206,11140,9198,9061,8938,6603,4571,8970,2170,0.194793537
Y01221,3056,2563,2529,2499,1892,1012,2627,429,0.140379581
Y01280,2176,1630,1598,1568,1163,463,2052,124,0.056985294
Y01281,4408,3830,3784,3760,2519,2393,2989,1419,0.321914701
Y01291,8808,7022,6921,6830,4771,3016,7498,1310,0.148728429
Y01652,6449,5482,5407,5333,3910,3418,4696,1753,0.271825089
Y01655,11200,9217,9138,9037,7145,2070,10606,594,0.053035714
Y01690,5035,3778,3730,3689,2669,1123,4633,402,0.079841112
Y01695,2913,2285,2249,2226,1616,676,2732,181,0.062135256
Y01719,7003,4994,4910,4838,3531,1289,6593,410,0.058546337
Y01756,6116,5127,5058,4986,3568,2633,4839,1277,0.208796599
Y01794,15495,12313,12097,11931,8584,5796,12615,2880,0.185866409
Y01795,3179,2427,2379,2336,1683,914,2851,328,0.1031771
Y01812,9110,7127,7027,6925,5091,3106,7639,1471,0.161470911
Y01839,6353,5047,4991,4925,3649,1543,5784,569,0.089563986
Y01922,11905,10304,10185,10071,7182,6146,8452,3453,0.290046199
Y01929,47345,36938,36350,35770,25952,14409,41213,6132,0.129517372
Y01948,1809,1493,1477,1462,1026,338,1735,74,0.040906578
Y01964,9886,6883,6787,6706,5263,1536,9394,492,0.049767348
Y02002,14822,13842,13823,13804,7931,802,14681,141,0.009512886
Y02117,14088,11682,11540,11402,7778,3470,13010,1078,0.076519023
Y02177,5611,4279,4221,4175,3032,1355,5107,504,0.089823561
Y02212,2549,2072,2032,2013,1428,1018,2055,494,0.193801491
Y02222,3838,3034,2998,2961,2211,1300,3306,532,0.138613861
Y02260,4245,3691,3662,3632,2781,1207,3848,397,0.09352179
Y02274,3762,2709,2672,2636,1984,776,3534,228,0.060606061
Y02319,5821,4163,4085,4003,2499,637,5695,126,0.021645765
Y02321,5558,4187,4133,4074,3035,1597,4836,722,0.129902843
Y02322,8550,6677,6586,6500,4717,2795,7296,1254,0.146666667
Y02325,4422,3041,2980,2917,2142,827,4116,306,0.069199457
Y02332,9600,7035,6864,6726,4766,1774,8897,703,0.073229167
Y02342,8872,6813,6698,6597,4990,1467,8545,327,0.036857529
Y02344,3440,2645,2608,2572,1765,1071,2942,498,0.144767442
Y02354,10275,8448,8340,8246,5835,4300,8053,2222,0.216253041
Y02378,6311,5114,5033,4967,3603,2451,5136,1175,0.186182855
Y02414,5151,3940,3875,3806,2885,1397,4656,495,0.096097845
Y02423,42126,35528,35210,34914,23977,8280,39278,2848,0.067606704
Y02442,4299,2961,2893,2823,2006,627,4116,183,0.042568039
Y02463,12080,9422,9339,9230,5956,1314,11824,256,0.021192053
Y02466,11334,8184,8090,7995,6259,2054,10604,730,0.064407976
Y02469,9252,6514,6369,6230,4521,1842,8587,665,0.071876351
Y02476,10512,8696,8645,8617,6328,1034,10227,285,0.027111872
Y02494,5598,4314,4271,4227,3008,627,5445,153,0.02733119
Y02495,534,467,465,459,322,60,522,12,0.02247191
Y02506,8415,6373,6278,6188,4608,2474,7445,970,0.115270351
Y02510,5182,4188,4146,4107,2877,1651,4381,801,0.154573524
Y02517,16701,13888,13734,13575,9921,6097,13756,2945,0.176336746
Y02519,8486,6510,6435,6363,4255,1461,8027,459,0.054089088
Y02520,5571,3822,3743,3662,2725,1069,5273,298,0.053491294
Y02521,11371,8299,8145,8018,5684,2946,10164,1207,0.106147217
Y02526,8260,7227,7185,7136,3489,869,8054,206,0.024939467
Y02567,4763,3126,3050,2981,2064,912,4407,356,0.074742809
Y02571,6593,4919,4858,4804,3668,1420,5935,658,0.099802821
Y02572,2703,2193,2160,2133,1671,957,2368,335,0.123936367
Y02575,21317,15059,14817,14584,11112,2891,20622,695,0.032603087
Y02578,11260,10702,10690,10674,5333,816,11059,201,0.017850799
Y02585,828,726,723,720,524,78,822,6,0.007246377
Y02586,4184,3004,2963,2907,2026,659,4020,164,0.039196941
Y02589,9667,8456,8400,8346,5320,1160,9313,354,0.036619427
Y02594,2710,2126,2103,2075,1426,1074,2141,569,0.2099631
Y02605,3452,2518,2473,2422,1699,889,3074,378,0.109501738
Y02606,5977,4443,4381,4300,3140,1281,5550,427,0.071440522
Y02611,9820,7237,7160,7093,5389,1820,9128,692,0.070468432
Y02622,10954,10263,10249,10235,5062,538,10851,103,0.009402958
Y02625,1076,1076,1076,1076,272,1064,104,972,0.903345725
Y02626,4649,3499,3453,3414,2438,1312,4046,603,0.129705313
Y02627,12843,9102,8908,8713,5971,3206,11456,1387,0.107996574
Y02633,5500,4554,4508,4457,3300,2655,4164,1336,0.242909091
Y02636,5718,4257,4207,4153,2862,968,5385,333,0.058237146
Y02639,9498,7029,6940,6872,5465,1574,9019,479,0.05043167
Y02646,9590,7283,7210,7148,5253,1559,9154,436,0.045464025
Y02653,4203,3190,3149,3116,2155,1386,3544,659,0.156792767
Y02656,4015,3246,3209,3177,2391,1779,3074,941,0.234371108
Y02657,7538,5642,5539,5455,3798,2120,6591,947,0.125630141
Y02658,2653,2081,2054,2019,1474,605,2456,197,0.07425556
Y02663,4126,2967,2927,2889,2134,1074,3713,413,0.100096946
Y02669,3740,3156,3128,3103,2125,984,3405,335,0.089572193
Y02671,18348,14029,13845,13692,10487,2749,17637,711,0.038750818
Y02672,10447,7824,7745,7658,5935,1641,9965,482,0.046137647
Y02674,702,702,702,702,616,266,668,34,0.048433048
Y02676,9685,9274,9255,9217,4807,856,9499,186,0.019204956
Y02684,3000,2376,2344,2320,1629,702,2790,210,0.07
Y02686,4811,4131,4106,4086,2707,704,4662,149,0.030970692
Y02692,13483,10994,10881,10788,7574,1735,13129,354,0.026255284
Y02701,9674,7122,7003,6872,5085,1991,9069,605,0.062538764
Y02707,6294,4726,4639,4561,3348,1726,5655,639,0.101525262
Y02713,4966,3737,3697,3655,2690,1190,4498,468,0.094240838
Y02718,3191,2369,2332,2302,1646,873,2807,384,0.120338452
Y02720,3183,2230,2199,2150,1512,601,3004,179,0.056236255
Y02721,2537,1700,1671,1631,1224,438,2398,139,0.054789121
Y02736,5610,3878,3794,3725,2699,1039,5262,348,0.062032086
Y02747,13791,9893,9758,9622,7050,2716,12898,893,0.064752375
Y02751,10804,9333,9297,9267,6367,1872,10052,752,0.06960385
Y02753,4721,3281,3214,3142,2208,1052,4327,394,0.083456895
Y02755,9491,7102,7004,6917,4965,1707,8946,545,0.057422822
Y02757,12407,8924,8778,8653,6228,2445,11513,894,0.072056097
Y02767,5317,4150,4107,4055,2812,1133,4868,449,0.084446116
Y02769,6624,5219,5175,5125,3782,1463,6125,499,0.075332126
Y02787,6651,5127,5070,5018,3507,1099,6393,258,0.038791159
Y02790,6483,4414,4325,4245,2914,1117,6091,392,0.060465834
Y02794,10562,6639,6440,6241,4081,1108,10223,339,0.032096194
Y02795,3847,2906,2882,2846,2107,830,3555,292,0.075903301
Y02807,12884,9335,9219,9139,6838,1845,12403,481,0.037333126
Y02811,11379,8392,8307,8215,6699,2198,10628,751,0.06599877
Y02816,3257,2768,2748,2730,2125,820,2972,285,0.087503838
Y02827,3944,2808,2735,2666,1692,561,3743,201,0.050963489
Y02842,4556,3765,3734,3683,2777,899,4302,254,0.055750658
Y02847,10832,9507,9472,9427,6018,1329,10555,277,0.025572378
Y02849,13565,12955,12943,12930,6657,535,13473,92,0.00678216
Y02867,4132,3271,3238,3205,2308,962,3743,389,0.094143272
Y02875,3494,2466,2419,2379,1630,498,3338,156,0.044647968
Y02885,3110,2214,2172,2131,1516,616,2917,193,0.062057878
Y02886,3822,3004,2976,2943,2271,1167,3362,460,0.120355835
Y02890,5424,4199,4137,4081,2458,616,5249,175,0.032264012
Y02893,16295,12025,11794,11586,8088,4372,14419,1876,0.11512734
Y02900,15180,10721,10574,10410,8071,2029,14595,585,0.038537549
Y02906,7610,6354,6298,6209,3936,1275,7166,444,0.058344284
Y02928,14253,11446,11337,11234,7539,1813,13821,432,0.030309409
Y02933,4928,3547,3475,3412,2400,1133,4478,450,0.091314935
Y02936,3481,2567,2528,2495,1881,827,3199,282,0.081011204
Y02946,9238,8636,8621,8605,4653,456,9138,100,0.010824854
Y02960,6157,4587,4520,4445,2924,749,5981,176,0.02858535
Y02962,6026,4680,4626,4574,3402,735,5902,124,0.020577498
Y02973,8537,6455,6372,6294,4798,1510,8087,450,0.052711725
Y02974,9431,6785,6671,6586,5043,1257,9193,238,0.025235924
Y02986,5212,4357,4321,4287,2835,649,5094,118,0.022640061
Y02987,19016,13958,13716,13497,9367,2954,18076,940,0.049432057
Y03023,14332,11475,11350,11203,7178,1475,13870,462,0.032235557
Y03035,22608,18452,18228,18010,13857,6830,20069,2539,0.112305379
Y03049,14763,10919,10760,10600,7765,2535,14018,745,0.050463998
Y03051,138,111,108,106,84,38,125,13,0.094202899
Y03052,13500,10562,10398,10251,7592,4245,11730,1770,0.131111111
Y03063,8482,7482,7419,7361,5084,1683,8033,449,0.052935628
Y03079,13069,10368,10200,10061,7229,4572,10917,2152,0.164664473
Y03103,151,151,151,151,123,35,147,4,0.026490066
Y03112,56,37,36,36,26,9,52,4,0.071428571
Y03124,5950,4527,4452,4371,3064,1896,5079,871,0.146386555
Y03135,10281,8953,8875,8808,6523,2541,9391,890,0.086567455
Y03222,5863,4957,4901,4832,3467,2877,4367,1496,0.255159475
Y03296,6275,5174,5127,5081,3552,1600,5498,777,0.123824701
Y03366,4541,3171,3094,3034,2033,803,4249,292,0.064303017
Y03402,19285,14161,13864,13593,9730,4275,17877,1408,0.073010111
Y03441,5806,5228,5202,5185,3619,947,5537,269,0.046331381
Y03587,5257,4259,4216,4172,3101,1445,4723,534,0.101578847
Y03595,6964,5757,5697,5640,4039,2701,5567,1397,0.200603102
Y03597,6355,4219,4103,4013,2631,876,6059,296,0.046577498
Y03602,5190,4393,4344,4298,3207,2624,3905,1285,0.247591522
Y03656,5570,4479,4435,4380,3138,2118,4521,1049,0.188330341
Y03663,8907,7112,7019,6909,4861,1891,8208,699,0.078477602
Y03664,9205,7569,7480,7406,5253,2048,8426,779,0.08462792
Y03671,4801,3546,3482,3441,2652,1156,4476,325,0.06769423
Y03755,10222,8185,8111,8055,5764,1594,9691,531,0.051946781
Y04225,824,824,824,824,219,793,105,719,0.872572816
Y04266,4083,3338,3302,3264,2302,1666,3286,797,0.195199608
Y04273,17220,14686,14563,14447,8257,1288,16962,258,0.014982578
Y04662,3154,2114,2090,2060,1538,382,3045,109,0.03455929
Y04664,4366,3790,3754,3720,2685,2390,3105,1261,0.288822721
Y04809,2413,1776,1745,1715,1263,649,2169,244,0.101118939
Y04882,2846,2302,2269,2248,1580,1073,2296,550,0.193253689
Y04883,713,545,539,526,368,129,679,34,0.047685835
Y04884,3481,2966,2930,2898,2049,1553,2684,797,0.228957196
Y04925,6424,4753,4674,4590,3613,1563,5917,507,0.07892279
Y04942,11626,11584,11583,11556,437,39,11622,4,0.000344056
Y04947,3599,2679,2642,2611,1856,585,3363,236,0.06557377
Y04951,5644,4166,4124,4061,2748,607,5526,118,0.020907158
Y04952,3903,3174,3123,3070,2251,1370,3286,617,0.158083525
Y04957,31102,25643,25304,24989,17613,13620,23978,7124,0.229052794
Y04965,3913,2772,2706,2648,1850,454,3801,112,0.02862254
Y04968,5614,5141,5127,5101,2349,806,5379,235,0.041859637
Y04969,4524,3166,3109,3059,2212,829,4216,308,0.068081344
Y04977,4971,4110,4070,4036,2803,2049,3977,994,0.199959767
Y04995,19863,16238,16026,15809,11224,7850,16035,3828,0.192720133
Y05023,3941,3158,3128,3095,2268,1545,3167,774,0.196396854
Y05080,2708,2268,2233,2202,1505,740,2391,317,0.117060561
Y05167,12512,9933,9826,9708,6789,1999,12041,471,0.037643862
Y05212,4097,3023,2987,2937,2050,788,3806,291,0.071027581
Y05248,3003,2425,2380,2347,1705,1125,2510,493,0.164169164
Y05286,14715,10693,10492,10313,7519,3638,13385,1330,0.090383962
Y05291,3691,3041,3000,2963,2029,1652,2766,925,0.250609591
Y05317,7695,6049,5945,5853,4266,2433,6767,928,0.120597791
Y05318,6128,4897,4800,4711,3396,1981,5377,751,0.122552219
Y05330,3426,2994,2969,2953,1659,351,3348,78,0.022767075
Y05346,3499,2678,2628,2582,1893,901,3215,284,0.081166047
Y05349,4854,4162,4143,4122,2894,508,4744,110,0.022661722
Y05363,3360,2552,2515,2474,1776,996,2916,444,0.132142857
Y05364,3500,2648,2614,2577,1828,926,3183,317,0.090571429
Y05369,5989,4741,4682,4621,3437,2206,4920,1069,0.178493905
Y05412,69,69,69,69,22,1,69,0.0000001,1E-12
Y05622,3392,2286,2239,2212,1567,630,3169,223,0.065742925
Y05690,6647,4828,4746,4664,3448,1804,5850,797,0.119903716
Y05733,6273,5041,4967,4908,3451,2114,5269,1004,0.160051012
Y05750,136,136,136,135,70,35,120,16,0.117647059
Y05826,5902,3982,3879,3775,2627,630,5734,168,0.028464927
Y06007,6173,4819,4758,4681,3273,2000,5285,888,0.14385226
Y06113,372,372,372,372,67,372,12,360,0.967741935
Y06218,6708,5250,5172,5110,3821,1809,6087,621,0.092576029
Y06275,6292,4887,4816,4747,3416,1871,5497,795,0.126350922
Y06356,9858,7537,7397,7250,5153,2923,8702,1156,0.117265165
Y06378,6059,4371,4281,4213,2879,784,5836,223,0.036804753
Y06443,11801,9568,9436,9315,6632,4687,9464,2337,0.198034065
Y06507,5505,4519,4474,4421,3284,2133,4544,961,0.174568574
